#####################################################
#
# EliXa Spanish polarity lexicon
#
# Version: 1.0
# Last update: (2015/10/03)
# Authors: Xabier Saralegi (x.saralegi@elhuyar.com) , Iñaki San Vicente (i.sanvicente@elhuyar.com)
#          Elhuyar Foundation, R&D department. 
# -----------------------------------------
#
# EliXa Spanish polarity lexicon is based on the ElhPolar_es polarity lexicon for Spanish. It was created from different sources, and includes both negative and positive words. You can find a detailed description of the content, as well as, the way the lexicon was built in following publication:
#
#      - Saralegi X., San Vicente I.. 2013. "Elhuyar at TASS 2013". In Proceedings of "XXIX Congreso de la Sociedad EspaÃ±ola de Procesamiento de lenguaje natural". Workshop on Sentiment Analysis at SEPLN (TASS2013). Madrid. pp. 143-150.  ISBN: 978-84-695-8349-4
#
# If you use this lexicon please cite the article above.
#
#
# License
# -----------
#
# This resource is distributed under the Lesser General Public License For Linguistic Resources (LGPLLR). You will find the license at http://sanskrit.inria.fr/DATA/LGPLLR.html
#
#
# Lexicon format
# ----------------
#
# The lexicon entries have the following notation: 
# 'lemma \t polarity'
# Where possible values for polarity are: positive | negative
# 
# Lines starting with the '#' character are comments. The lexicon includes various word lists obtained from different sources. At the beginning of each section a comment explains the following elements.
#
######################################################


abajamiento	negative
abajo	negative
abandonado	negative
abandonamiento	negative
abandonar	negative
abandono	negative
abaratar	negative
abarrotado	negative
abatidamente	negative
abatido	negative
abatimiento	negative
abatir	negative
abatirse	negative
abdicar	negative
aberración	negative
aberrante	negative
abierto	positive
abismo	negative
abochornar	negative
abofetear	negative
abogar#por	positive
abollar	negative
a#bombo#y#platillo	positive
abominablemente	negative
abominable	negative
abominacion	negative
abominación	negative
abominar	negative
abordar	negative
aborrecer	negative
aborreciblemente	negative
aborrecible	negative
aborrecimiento	negative
abortar	negative
aborto	negative
abrasador	negative
abrasivo	negative
abrazar	positive
abrazarse	positive
abrazooooo	positive
abrazo	positive
abrazos	positive
abrir#camino	positive
abrir	negative
abrumar	negative
absentismo	negative
absolutismo	negative
absolver	positive
absorbente	positive
absurdamente	negative
absurdez	negative
absurdo	negative
abuchear	negative
abucheo	negative
a#buenas#horas#mangas#verdes	negative
abundancia	positive
abundante	positive
abundar	positive
abundoso	positive
aburridísimo	negative
aburrido	negative
aburrimiento	negative
aburrir	negative
abusar#de	negative
abusar	negative
abusica	negative
abusivo	negative
abuso	negative
abusón	negative
abyectamente	negative
abyecto	negative
acabado	negative
acabalar	positive
acabar#como#el#rosario#de#la#aurora	negative
acallar	positive
acalorado	negative
a#cara#de#perro	negative
acariciar	positive
acartonado	negative
acatar	positive
acaudalado	positive
acaudalados	positive
acceder	positive
accidente	negative
acción	positive
acechar	negative
acelerar	positive
aceptable	positive
aceptación	positive
aceptar	positive
acepto	positive
acercar#el#ascua#a#su#sardina	negative
acertadamente	positive
acertado	positive
acertar	positive
achachay	positive
achalay	positive
achantado	negative
achaque	negative
achispado	negative
achuchón	positive
aciago	negative
acibarar	negative
acicate	positive
acido	negative
ácido	negative
a#ciegas	negative
acierto	positive
aclamacion	positive
aclamación	positive
aclamar	positive
aclarar	positive
aclararse	positive
acobardar	negative
acocojada	negative
acogedor	positive
Acogedor	positive
acoger#con#agrado	positive
acoger	positive
acogida	positive
acojonado	negative
acojonante	positive
acojonar	negative
acometedor	negative
acometer	negative
acometiente	negative
acometimiento	negative
acometividad	negative
acomodadamente	positive
acomodarse	positive
acomplejado	negative
acongojado	negative
acongojar	negative
aconsejable	positive
acoquinamiento	negative
acoquinar	negative
acordar	positive
acortarse	negative
acosar	negative
acoso	negative
acre	negative
acribillar	negative
acrimonia	negative
acritud	negative
activo	positive
actorazo	positive
actualizable	positive
acuchillar	negative
acuciar	positive
acucioso	positive
acuerdo	positive
acuitadamente	negative
acuitar	negative
acusacion	negative
acusación	negative
acusar	negative
acusica	negative
adaptarse	positive
adecuadamente	positive
adecuado	positive
adecuar	positive
a#dedo	negative
adelante	positive
adherente	positive
adherido	positive
adhesión	positive
adicción	negative
adicto	negative
adinerado	positive
adiós	negative
adivinar	positive
adjudicar	positive
admirablemente	positive
admirable	positive
admiracion	positive
admiración	positive
admirado	positive
admirador	positive
admirar	positive
admitir	positive
admonitorio	negative
adoctrinamiento	negative
adolecer	negative
adorablemente	positive
adorable	positive
adoración	positive
adorador	positive
adorar	positive
adornar	positive
a#dos#velas	negative
adquisición	positive
adulación	positive
adular	positive
adulteración	negative
adulterado	negative
adulterar#con#drogas	negative
adulterar	negative
a#duras#penas	negative
adusto	negative
adversario	negative
adversidad	negative
adversión	negative
adverso	negative
advertencia	negative
a#enemigo#que#huye#puente#de#plata	negative
a#escondidas	negative
afabilidad	positive
afable	positive
afamado	positive
afanar	negative
afan	negative
afán	positive
afeccion	negative
afectado	negative
afectar	negative
afectivo	positive
afecto	positive
afectuosamente	positive
afectuosidad	positive
afectuoso	positive
afeminado	negative
aferrar	negative
afervorizar	positive
affaire	positive
aficionar	positive
aficion	positive
afición	positive
afinidad	positive
afirmación	positive
afirmar	positive
afirmativamente	positive
afirmativo	positive
afliccion	negative
aflicción	negative
afligidamente	negative
afligido	negative
afligir	negative
afligirse	negative
aflojamiento	negative
a#flote	positive
afortunadamente	positive
afortunado	positive
afrenta	negative
afrentar	negative
afrodisíaco	positive
afrontar	negative
afuera	negative
agachar#la#cabeza	negative
agachar#las#orejas	negative
agarrada	negative
agarrado	negative
agarrar#a#un#clavo#ardiendo	negative
agarrar	negative
agasajar	positive
agilidad	positive
agilmente	positive
ágil	positive
agitacion	negative
agitación	negative
agitado	negative
agitador	negative
agitar	negative
agobiado	negative
agobiantemente	negative
agobiante	negative
agobiar	negative
agobio	negative
agolpamiento	negative
agónico	negative
agotado	negative
agotadoramente	negative
agotador	negative
agotamiento	negative
agotar	negative
agradablemente	positive
agradable	positive
Agradable	positive
agradar	positive
agradecer	positive
agradecido	positive
agradecimiento	positive
agravamiento	negative
agravante	negative
agravar	negative
agraviar	negative
agravio	negative
agredir	negative
agresión	negative
agresivamente	negative
agresividad	negative
agresivo	negative
agresor	negative
agriado	negative
agriamente	negative
agrietar	negative
agrietarse	negative
agrio	negative
a#grito#pelado	negative
aguantar	negative
aguar#la#fiesta	negative
agudeza	negative
agudo	positive
agüero	negative
aguijón	negative
agusto	positive
aguzar	positive
aherrojar	negative
ahínco	positive
ahíto	positive
ahogar#en#un#vaso#de#agua	negative
ahogar	negative
ahogarse	negative
ahogo	negative
ahuecamiento	negative
ahuecar#el#ala	negative
a#huevo	positive
a#hurtadillas	negative
ahuyentar	negative
airadamente	negative
airado	negative
airamiento	negative
airar	negative
airoso	positive
aislado	negative
aislar	negative
ajeno	negative
ajetreado	negative
ajo#y#agua	negative
ajustar	positive
ajuste	negative
alabanza	positive
alabar	positive
a#la#chita#callando	negative
a#la#deriva	negative
a#la#ligera	negative
a#la#moda	positive
alardear	negative
alarmado	negative
alarma	negative
alarmantemente	negative
alarmante	negative
alarmar	negative
a#la#sombra	negative
a#la#tremenda	negative
albedrío	positive
alborotado	negative
alborotador	negative
alboroto	negative
alborozar	positive
alborozarse	positive
alborozo	positive
alcista	positive
alcoholico	negative
alcornoque	negative
alegrar	positive
alegrarse	positive
alegremente	positive
alegre	positive
alegria	positive
alegría	positive
alegro	positive
aleluya	positive
al#enemigo#ni#agua	negative
alentadoramente	positive
alentador	positive
alentar	positive
alergia	negative
alerta	negative
alertar	negative
alevosía	negative
alfilerazo	negative
algazara	positive
álgido	positive
aliado	positive
aliar	positive
aliarse	positive
alicaído	negative
aliciente	positive
alienación	negative
alienar	negative
alifafe	negative
alimentar	positive
alimenticio	positive
aliquebrado	negative
alirón	positive
aliviado	positive
aliviar	positive
alivio	positive
allegar	positive
alma	positive
alocado	negative
alta#calidad	positive
altaneria	negative
altanero	negative
alterado	negative
altercado	negative
altiveza	negative
altivez	negative
altivo	negative
altruismo	positive
altruista	positive
alucinación	negative
alucinante	positive
alucinar#en#colores	negative
alucinar	negative
alud	negative
alza	positive
alzar#en#armas	negative
alzar	positive
amabilidad	positive
Amabilidad	positive
amabilisimo	positive
amablemente	positive
amable	positive
amado	positive
amalaya	negative
a#mamarla	negative
amante	positive
amar#a	positive
amargadamente	negative
amarga#derrota	negative
amarga#despedida	negative
amargado	negative
amargamente	negative
amargar	negative
amargo	negative
amargor	negative
amargura	negative
amar	positive
amartelado	positive
amartelar	positive
amasijo#de#hierros	negative
amateur	negative
amativo	positive
amatorio	positive
ambicion	positive
ambición	positive
ambicioso	positive
ambigüedad	negative
ambiguo	negative
ambivalente	negative
amedentrar	negative
a#medio#gas	negative
amedrentador	negative
amedrentamiento	negative
amenamente	positive
amenazadoramente	negative
amenazador	negative
amenaza	negative
amenazar	negative
ameno	positive
amigabilidad	positive
amigablemente	positive
amigable	positive
amigo	positive
amilanar	negative
a#mí#plin	negative
amistad	positive
amistosamente	positive
amistoso	positive
amnistía	positive
amohinar	negative
amonestación	negative
amonestar	negative
amoral	negative
amorosamente	positive
amorosidad	positive
amoroso	positive
amor	positive
amor#propio	positive
amoscamiento	negative
ampliamente	positive
ampliar	positive
amplio#abanico#de#posibilidades	positive
amplio	positive
amplisimo	positive
ampolla	negative
ampollar	negative
ampollarse	negative
ampuloso	negative
amputar	negative
amuleto	positive
amurriar	negative
analfabeto	negative
anal	negative
anarquía	negative
ancha#es#castilla	negative
andar#a#la#greña	negative
andar#a#salto#de#mata	negative
andar#con#rodeos	negative
andar#de#capa#caída	negative
andar#el#mundo#al#revés	negative
andar#por#las#ramas	negative
andrajoso	negative
anémico	negative
angelical	positive
angelico	positive
angélico	positive
ángel	positive
angustiadamente	negative
angustiado	negative
angustia	negative
angustiar	negative
angustiarse	negative
angustiosamente	negative
angustioso	negative
anhelo	positive
añicos	negative
animación	positive
animado	positive
animadversión	negative
animal	negative
animar	positive
animarse	positive
ánimo	positive
animosidad	negative
animoso	positive
aniquilacion	negative
aniquilación	negative
aniquilamiento	negative
aniquilar	negative
año#catapún	negative
año#de#la#pera	negative
anodino	negative
anomalía	negative
anómalo	negative
anonadar	negative
añorado	positive
añorar	negative
anorexia	negative
anormal	negative
ansiado	positive
ansia	negative
ansiedad	negative
ansioso	negative
antagonico	negative
antagónico	negative
antagonismo	negative
antagonista	negative
antediluviano	negative
anticipar	positive
anticriminal	positive
anticuado	negative
antiestético	negative
antiguo	negative
antihigiénico	negative
antinatural	negative
antipatía	negative
antipatico	negative
antipático	negative
antipaticos	negative
antitetico	negative
antojadizo	negative
antro	negative
anular	negative
apabullante	negative
apabullar	negative
apaciblemente	positive
apacible	positive
apaciguar	positive
apagado	negative
apaga#y#vámonos	negative
apalear	negative
aparato	negative
aparatoso	negative
aparentar	negative
apasionadamente	positive
apasionado	positive
apasionamiento	positive
apasionantemente	positive
apasionante	positive
apasionar	positive
apatía	negative
apático	negative
apear#del#burro	negative
apedreables	negative
apego	positive
apenado	negative
apenar	negative
apenas	negative
apesadumbrado	negative
apesadumbrar	negative
a#pesar#de	negative
apestar	negative
apestoso	negative
apetecer	positive
apiadarse	negative
apiñarse	negative
aplacar	positive
aplanar	negative
aplastar	negative
aplatanante	negative
aplaudir	positive
aplauso	positive
aplicado	positive
apocalipsis	negative
apocalíptico	negative
apocar	negative
apoderarse	negative
apogeo	positive
aporrear	negative
apostar#por	positive
apoteósico	positive
apoyar	positive
apoyarse	positive
apoyo	positive
apreciable	positive
apreciación	positive
apreciado	positive
apreciar#mucho	positive
apreciar	positive
aprecio	positive
apremiante	negative
aprension	negative
aprensión	negative
aprensivo	negative
apresurado	negative
apretar#el#cinturón	negative
apretar	negative
apretura	negative
aprieto	negative
aprobación	positive
aprobado	positive
aprobar	positive
aprobatorio	positive
apropiadamente	positive
apropiado	positive
aprovechar#el#tiempo	positive
aprovechar	positive
aptitudes	positive
aptitud	positive
apto	positive
apuesta#segura	positive
apuesto	positive
apuñalar	negative
apuntar#a#un#bombardeo	negative
apuro	negative
aquejar	negative
aquellos#polvos#trajeron#estos#lodos	negative
aquietar	positive
aquí#hay#gato#encerrado	negative
arañado	negative
araña	negative
aranazo	negative
arbitrario	negative
arcaico	negative
archifamoso	positive
arder	negative
ardid	negative
ardientemente	positive
ardiente	positive
ardor	positive
arduo	negative
arisco	negative
aristocrático	positive
armar#la#de#dios#es#cristo	negative
armar#la#de#dios	negative
armar#la#de#san#quintín	negative
armar#la#marimorena	negative
armarla	negative
armar#una#buena	negative
armar#una#de#las#gordas	negative
armonía	positive
armoniosamente	positive
armonioso	positive
arpia	negative
arpía	negative
arrancar	negative
arranque	positive
arrarray	negative
arrasar	negative
arrastradamente	negative
arrastrada	negative
arrastrado	negative
arrastrar	negative
arrebatado	positive
arrebatamiento	negative
arrebatar	negative
arrebato	positive
arredrar	negative
arreglado	positive
arreglar#bien	positive
arreglar	positive
arremeter	negative
arrepentido	negative
arrepentimiento	negative
arrepentir	negative
arrepentirse#de	negative
arrepentirse	positive
arriba	positive
arriesgado	negative
arriesgar	negative
arrimar#el#ascua#a#su#sardina	negative
arrimar#el#hombro	positive
arrobamiento	positive
arrobar	positive
arrobo	positive
arrogancia	negative
arrogantemente	negative
arrogante	negative
arrojado	positive
arrojar	negative
arrojo	positive
arrollador	positive
arropar	positive
arrugado	negative
arruinar	negative
arsa	positive
arte	positive
artero	negative
artificial	negative
artificiosamente	positive
artimañas	negative
artista	positive
asaltacunas	negative
asaltar	negative
asalto	negative
a#salvo	positive
asar	negative
ascendente	positive
ascender	positive
ascendiente	positive
asco	negative
aseado	positive
asediar	negative
asedio	negative
asegurar	positive
asentarse	positive
asentimiento	positive
asentir	positive
asequible	positive
asesinar	negative
asesinato	negative
asesino	negative
asesino#sanguinario	negative
asfixiante	negative
asfixiar	negative
asfixiarse	negative
asiduo	positive
asignar	positive
asimetria	negative
asistir#la#razón	positive
asno	negative
asolar	negative
asombrar	positive
asombrarse	positive
asombro	positive
asombrosamente	positive
asombroso	positive
ásperamente	negative
aspereza	negative
áspero	negative
aspiracion	positive
aspiración	positive
aspirar	positive
asqueadamente	negative
asqueado	negative
asquear	negative
asquerosamente	negative
asquerosidad	negative
asqueroso	negative
astral	positive
astro	positive
astroso	negative
astucia	positive
astutamente	positive
astuto	positive
asunto	positive
asurar	negative
asustadizo	negative
asustado	negative
asustar	negative
asustarse	negative
atacar	negative
ataque#de#histeria	negative
ataque	negative
ataque#violento	negative
atar#cabos	positive
atar#de#pies#y#manos	negative
atascar	negative
atasco#monumental	negative
atatay	positive
atemorizado	negative
atemorizante	negative
atemorizar	negative
atención#exquisita	positive
atencion	positive
atentado	negative
atentamente	positive
atentar	negative
atento	positive
aterrado	negative
aterradoramente	negative
aterrador	negative
aterrar	negative
aterrorizador	negative
aterrorizar	negative
atestar	negative
atizar	negative
a#todo#correr	negative
atolladero	negative
atónito	negative
atontar	negative
a#tope	positive
atormentadamente	negative
atormentado	negative
atormentar	negative
atosigar	negative
atrabiliario	negative
atracción	positive
atraco	negative
atractivamente	positive
atractivo	positive
atraer	positive
atragantar	negative
a#trancas#y#barrancas	negative
atrasado	negative
atrasarse	negative
atrás	negative
atrayentemente	positive
atrayente	positive
atreverse	positive
atrevidamente	positive
atrevido	positive
atrevimiento	positive
atribulacion	negative
atribular	negative
atrición	negative
atrocidad	negative
atrofiar	negative
atrofiarse	negative
atropellar	negative
atropello	negative
atrozmente	negative
atroz	negative
atufar	negative
aturdimiento	negative
aturdir	negative
aturrullar	negative
audacia	positive
audazmente	positive
audaz	positive
auge	positive
aumentar	positive
aumento#en#valor	positive
aúpa	positive
ausente	negative
austeridad	negative
austero	negative
autenticamente	positive
auténticamente	positive
autentico	positive
auténtico	positive
autocomplacencia	positive
autodestrucción	negative
autónomo	positive
autoritario	negative
autoritarismo	negative
autorizacion	positive
autorización	positive
autorizado	positive
autorizar	positive
autorrespeto	positive
autosatisfacción	positive
autosatisfecho	positive
autosuficiencia	positive
avalancha	negative
avance#importante	positive
avance	positive
avanzado	positive
avanzar	positive
avaramente	negative
avaricia	negative
avaricioso	negative
avaro	negative
aventajar	positive
aventurado	positive
aventura	positive
aventurero	positive
avergonzado	negative
avergonzar	negative
avería	negative
averiarse	negative
aversion	negative
aversión	negative
avezar	positive
avidamente	positive
ávido	positive
aviso	positive
avivar	positive
avivarse	positive
a#viva#voz	negative
axfisiante	negative
ay#de#mí	negative
ay	negative
ayuda#económica	positive
ayuda	positive
ayudar	positive
azoramiento	negative
azorar	negative
azotar	negative
azote	negative
azucarar	positive
azuzar	negative
baba	negative
baboso	negative
bacanal	positive
bache	negative
bah	negative
bailar#con#la#más#fea	negative
bailar#el#agua	negative
bailar	positive
baile	positive
baja#calidad	negative
bajada#de#pantalones	negative
baja	negative
bajar#del#pedestal	negative
bajar#la#guardia	negative
bajar#las#orejas	negative
bajar#los#humos	negative
bajo#cuerda	negative
bajo	negative
bajon	negative
bajón	negative
baladron	negative
balbucear	negative
baldada	negative
baldado	negative
baldao	negative
baldío	negative
banalidad	negative
banal	negative
bandazo	negative
bandido	negative
baño#de#masas	positive
baño#de#multitudes	positive
baño#de#sangre	negative
banzai	positive
baquetear	negative
barato	positive
barbaridad	negative
barbarie	negative
barbaro	negative
bárbaro	negative
barbullar	negative
barco#naufragado	negative
barrila	negative
barrizal	negative
barrote	negative
basca	negative
bascosidad	negative
bascoso	negative
básicamente	positive
bastardo	negative
basto	negative
bastorra	negative
bastorro	negative
basura	negative
batallar	negative
batir#el#cobre	positive
bazofia	negative
beatificar	positive
beber#hasta#el#agua#de#los#floreros	negative
beca	positive
befa	negative
belico	negative
belicosidad	negative
belicoso	negative
beligerantemente	negative
beligerante	negative
bellaco	negative
bellamente	positive
belleza#exquisita	positive
belleza	positive
belleza#sublime	positive
bello	positive
bendecir	positive
bendición	positive
bendito	positive
benefactor	positive
beneficencia	positive
beneficiado	positive
beneficiario	positive
beneficiar	positive
beneficiarse	positive
beneficio	positive
beneficiosamente	positive
beneficioso	positive
benefico	positive
benéfico	positive
beneplácito	positive
benévolamente	positive
benevolencia	positive
benevolente	positive
benevolo	positive
benévolo	positive
benignamente	positive
benigno	positive
berenjenal	negative
berrinche	negative
besar	positive
besarse	positive
Besitos	positive
beso	positive
besos	positive
Besos	positive
bestialidad	negative
bestial	negative
bestia	negative
best#seller	positive
bestseller	positive
bicho#malo#nunca#muere	negative
bienandanza	positive
bien#arreglado	positive
bienaventurado	positive
bienaventuranza	positive
bien#definido	positive
bien#educado	positive
bienes	positive
bienestar	positive
bienhechor	positive
bien#intencionado	positive
bien#m	positive
¡bien!	positive
bien	positive
bienquerencia	positive
bienquerer	positive
bien#situado	positive
bienvenida	positive
bienvenido	positive
Bienvenido	positive
Bienvenidos	positive
bilis	negative
birlar	negative
birria	negative
bizarro	positive
bizbirondo	positive
blandengue	negative
blando	positive
blandura	positive
blanquear	negative
blanquísimo	positive
blasfemar	negative
blasfemia	negative
blasfemo	negative
bloquear	negative
bloqueo	negative
bobo	negative
bocata	negative
bocazas	negative
bochinche	negative
bochornoso	negative
bocon	negative
bodrio	negative
bofetada	negative
boga	positive
boicotear	negative
boicot	negative
boludo	negative
bombardear	negative
bombon	positive
bondadosamente	positive
bondadoso	positive
bondad	positive
bonhomía	positive
bonita	positive
bonito	positive
borbotar	negative
borde	negative
borracho	negative
borrar	negative
borrón	negative
borrón#y#cuenta#nueva	negative
borroso	negative
bostezar	negative
bostezo	negative
botarate	negative
braveza	negative
bravo	positive
bravucon	negative
bravura	negative
brecha	negative
brega	negative
bribón	negative
brillantemente	positive
brillante	positive
brillantez	positive
brillar	positive
brilló#con#luz#propia	positive
brilló#por#su#ausencia	negative
brillo	positive
brindar#por	positive
brindar	positive
brindis	positive
brío	positive
brioso	positive
bromear	negative
bronca	negative
bronco	negative
brote	negative
bruja	negative
brujo	negative
bruscamente	negative
brusco	negative
brutal#agresión	negative
brutalidad	negative
brutalmente	negative
brutal	negative
brutal#paliza	negative
bruto	negative
Bss	positive
buenamente	positive
buena	positive
Buena	positive
buenas#noches	positive
buenas	positive
buena#suerte	positive
buena#voluntad	positive
buenisima	positive
Buenísima	positive
buenisimas	positive
Buenisimo	positive
buenísimo	positive
Buenísimo	positive
Buenisimos	positive
bueno	positive
buenosdias	positive
Buenos#Dias	positive
BuenosDias	positive
buenosdías	positive
Buenos#Días	positive
BuenosDías	positive
buen#día	positive
buen#dia	positive
buenos	positive
Buenos	positive
buen	positive
Buen	positive
Buens	positive
bufar	negative
buf	negative
bufón	negative
buitre	negative
bujarra	negative
bula	positive
bullanguero	negative
bullicio	negative
bullicioso	negative
bunuelo	negative
burdo	negative
burla	negative
burlar	negative
burlarse#de	negative
burlarse	negative
burlas	negative
burlón	negative
burrada	negative
burro#grande#ande#o#no#ande	negative
burro	negative
buscar#evasivas	negative
buscar#las#cosquillas	negative
buscar#las#vueltas	negative
buscar#tres#pies#al#gato	negative
caballeria	positive
caballeriza	positive
caballero	positive
caballerosidad	positive
caballeroso	positive
cabal	positive
cabestro	negative
cabeza#de#turco	negative
cabezota	negative
cabizbajo	negative
cabizcaído	negative
cabreado	negative
cabrear	negative
cabrearse	negative
cabreo	negative
cabrón	negative
caca	negative
cacao	negative
cachete	negative
caco	negative
cada#cual#arrima#el#ascua#a#su#sardina	negative
cada#cual#habla#de#la#feria#según#le#va#en#ella	negative
cada#loco#con#su#tema	negative
cada#maestrillo#tiene#su#librillo	positive
cada#mochuelo#a#su#olivo	negative
cadaver	negative
cadáver	negative
caducar	negative
caer#a#pedazos	negative
caer#bien	positive
caer#de#culo	negative
caer#del#burro	negative
caer#del#guindo	negative
caer#de#un#guindo	negative
caer#el#alma#a#los#pies	negative
caer#el#mundo#encima	negative
caer#el#pelo	negative
caer#en#la#cuenta	positive
caer#en#saco#roto	negative
caer#gordo	negative
caer#la#cara#de#vergüenza	negative
caer#los#anillos	negative
caer	negative
caerse	negative
cagada	negative
cagar#de#miedo	negative
cagar	negative
cagarria	negative
cagarse	negative
caguendiós	negative
cagueta	negative
caida	negative
caída	negative
caído	negative
caja#tonta	positive
calabozo	negative
calaca	negative
calamidad	negative
calamitoso	negative
calavera	negative
calcinar	negative
calcular#mal	negative
calentar#la#cabeza	negative
cálida#bienvenida	positive
calidad#positiva	positive
calidad	positive
calidamente	positive
calidez	positive
calido	positive
cálido	positive
caliente	positive
callar#como#una#puta	negative
callar#como#un#muerto	negative
callar#la#boca	negative
calmado	positive
calma	positive
calmar	positive
calmarse	positive
calmo	positive
calofrío	negative
calor#abrasador	positive
calor#de#justicia	positive
calor	positive
calumnia	negative
calumniar	negative
calumnioso	negative
calurosamente	positive
calvario	negative
calvatrueno	negative
calzonazos	negative
camarada	positive
camaradería	positive
camelar	negative
camorra	negative
camorrista	negative
campante	positive
campeón	positive
canalla	negative
canastos	negative
cancamurria	negative
cancelar	negative
cancerígeno	negative
cáncer	negative
candido	positive
canela#fina	positive
cañero	positive
caníbal	negative
canijo	negative
cañí	positive
cañón	positive
cansado	negative
cansancio	negative
cansar	negative
cansarse	negative
cansina	negative
cansino	negative
cantada	negative
cantar#las#cuarenta	negative
cante	negative
caos	negative
caótico	negative
capacidad	positive
capacitado	positive
capa	negative
capaz	positive
capital	positive
capitular	negative
caprichosamente	negative
caprichoso	negative
captivar	positive
capturar	positive
capullo	negative
caracho	negative
caracoles	negative
carácter	positive
caradura	negative
carajo	negative
caramelo	positive
carcajada	positive
carcel	negative
cárcel	negative
cardenal	negative
carecer#de	negative
carecer	positive
carencia	negative
carente#de	negative
carente	negative
carga	negative
cargante	negative
cargar	negative
cargoso	negative
cariarse	negative
caricaturizar	negative
caridad	positive
caries	negative
cariño	positive
cariñosamente	positive
carinoso	positive
cariñoso	positive
carisimo	negative
carísimo	negative
Carísimo	negative
carisma	positive
carismático	positive
caritativo	positive
carniceria	negative
carnicería	negative
caro	negative
carroña	negative
cascarrabias	negative
caso#omiso	negative
casquivano	negative
castigar	negative
castigo	negative
casualmente	positive
casual	positive
cataclismo	negative
catarro	negative
catastrofe	negative
catástrofe	negative
catastrofico	negative
catastrófico	negative
catear	negative
cate	negative
cateta	negative
cateto	negative
caucion	negative
causar#baja	negative
causar#molestia#a	negative
causticamente	negative
caustico	negative
cáustico	negative
cautivado	positive
cautivadoramente	positive
cautivador	positive
cautivar	positive
cautivo	negative
cavar#su#propia#tumba	negative
caza	negative
ceder	negative
cegador	negative
cegar	negative
ceguera	negative
celebracion	positive
celebración	positive
celebrar	positive
celebre	positive
célebre	positive
celestial	positive
celo	positive
celosamente	positive
celos	negative
celoso	negative
cenit	positive
ceño	negative
censura	negative
censurar	negative
céntrico	positive
ceñudo	negative
ceporro	negative
cerebro	positive
cernerse	negative
cernicalo	negative
cerrar#en#banda	negative
cerrar	negative
cerril	negative
certeramente	positive
certero	positive
cese	positive
cetrino	negative
chachi	positive
chachi#guay	positive
chafar	negative
chafarse	negative
chalado	negative
chalar	negative
chancear	positive
chanchullo	negative
chantaje	negative
chanza	positive
chapado#a#la#antigua	negative
chapero	negative
chapucear	negative
chapucero	negative
chapuza	negative
charlatán	negative
charnega	negative
charnego	negative
charro	negative
chasco	negative
chic	positive
chiflado	negative
chillar	negative
chillido	negative
chillon	negative
chillón	negative
chinche	negative
chinga#tu#madre	negative
chingon	negative
chirria	negative
chirrian	negative
chirriante	negative
chirriar	negative
chirrido	negative
chismes	negative
chismorreo	negative
chispa	positive
chisporrotear	negative
chitón	negative
chivato	negative
chivo#expiatorio	negative
chocantemente	negative
chocante	negative
chocar	negative
choque	negative
choque#violento	negative
chorretones	negative
chota	negative
chotear	positive
choteo	positive
chufleta	negative
chulear	positive
chulesco	negative
chulito	negative
chulo	negative
chupar	negative
chupatintas	negative
chupi	positive
chupón	negative
chupóptera	negative
chupóptero	negative
churro	negative
chusma	negative
cicatriz	negative
ciegamente	negative
ciego	negative
cielo	positive
cielos	negative
cierto	positive
cima	positive
cínicamente	negative
cínico	negative
cinismo	negative
cipote	negative
circunspeccion	positive
civilizado	positive
civilizar	positive
cizañar	negative
clamar#al#cielo	negative
clamoroso	positive
claramente	positive
claridad	positive
clarísimo	positive
claro	positive
clásico	positive
claustrofóbico	negative
clavar	negative
clemente	positive
coaccionar	negative
coacción	negative
coágulo	negative
cobarde	negative
cobardía	negative
cobijo	positive
cobrar#una#vida	negative
cocer#demasiado	negative
cochambroso	negative
cochino	negative
cocolía	negative
coco	negative
codazo	negative
codicia	negative
codicioso	negative
coger#con#papel#de#fumar	negative
coger#el#toro#por#los#cuernos	negative
coger	negative
cogida	positive
cogollo	positive
coherencia	positive
coherente	positive
cohesión	positive
cohesivo	positive
cohibición	negative
cohibidamente	negative
cohibir	negative
coincidencia	positive
coincidir	positive
cojear	negative
cojear#ostensiblemente	negative
cojera	negative
cojo	negative
cojones	negative
cojonuda	positive
cojonudo	positive
colaboración	positive
colaborar	positive
colapsado	negative
colapso	negative
colar	negative
colegui	positive
cólera	negative
coléricamente	negative
colerico	negative
colérico	negative
colgada	negative
colgado	negative
colgar#las#botas	negative
colgar#muchas#medallas	negative
coligado	positive
colisionar	negative
colmado	positive
colmar	positive
colmo	negative
colocar#una#bomba#en	negative
colosal	positive
colusión	negative
combate	negative
combatir	negative
combativo	negative
comedia	negative
comedido	positive
comentario#desdeñoso	negative
comerciar	positive
comerse#el#tarro	negative
comerse#la#olla	negative
comerse#un#marrón	negative
comer#una#rosca	negative
comer#un#marrón	negative
comer#y#callar	negative
cometer#un#desliz	negative
cómico	negative
comida#basura	negative
comida#exquisita	positive
cómodamente	positive
comodas	positive
comodidad	positive
como#Dios#manda	positive
comodísima	positive
comodísimas	positive
comodísimo	positive
comodo	positive
cómodo	positive
Cómodo	positive
como#quien#no#quiere#la#cosa	negative
compacto	positive
compadecer	negative
compadecerse	negative
compañerismo	positive
compañero	positive
compartir	positive
compasion	positive
compasión	positive
compasivo	positive
compatibilidad	positive
compatiblemente	positive
compatible	positive
compensación	positive
compensar	positive
competente	positive
competitivo	positive
compis	positive
complacencia	positive
complacer	positive
complacible	positive
complacido	positive
complaciente	positive
complejo	negative
completamente	positive
completísimo	positive
complicacion	negative
complicación	negative
complicado	negative
complicar	negative
complot	negative
comportarse#como#un#loco	negative
comportarse#mal	negative
cómprate#un#bosque#y#piérdete	negative
comprender	positive
comprensible	positive
comprensión	positive
comprensivo	positive
comprometer	positive
compromiso	positive
compulsivo	negative
compunción	negative
compungidamente	negative
compungir	negative
comulgar#con#ruedas#de#molino	negative
comúnmente	positive
comun	negative
con#afán	positive
con#amargura	negative
coñazo	negative
conceder	positive
concepcion	positive
concernir	positive
concha#tu#madre	negative
concienciado	positive
conciencia	positive
concienzudo	positive
conciliación	positive
conciliar	positive
conciliatorio	positive
conciso	positive
concitar	negative
con#claridad	positive
concluyente	positive
concordancia	positive
concordar	positive
concreto	positive
con#cuidado	positive
condenación	negative
condenado	negative
condena	negative
condenar#al#ostracismo	negative
condenar	negative
condescendencia	negative
condescender	positive
condescendiente	negative
con#desprecio	negative
condimento	positive
condolencia	negative
condoler	negative
con#el#pan#de#tus#hijos#no#se#juega	negative
con#engreimiento	negative
con#entusiasmo	positive
con#esperanza	positive
con#experiencia	positive
confabulación	negative
conferir	positive
confesar	negative
confesarse	negative
confesión	negative
confiabilidad	positive
confiado	positive
confianza	positive
confiar#en	positive
confiar	positive
conficto	negative
confidente	positive
confirmación	positive
confirmar	positive
conflictivo	negative
conflicto	negative
conflictos	negative
conforme	positive
confortablemente	positive
confortable	positive
Confortable	positive
confortación	positive
confortador	positive
confortar	positive
confort	positive
confraternidad	positive
confrontacion	negative
confrontación	negative
confrontar	negative
confundido	negative
confundir	negative
confusion	negative
confusión	negative
confuso	negative
congeniar	positive
congestionado	negative
congestión	negative
congoja	negative
congojoso	negative
congraciar	positive
congratular	positive
con#ilusión	positive
con#la#cabeza#bien#alta	positive
con#los#pies#por#delante	negative
conminar	negative
conmiseracion	negative
conmiseración	positive
conmocionar	negative
conmocion	negative
conmovedor	positive
conmover	positive
con#mucho#gusto	positive
con#mucho	positive
conocer	positive
conocido	positive
coño	negative
conquista	positive
conquistar	positive
con#razón	positive
con#recelo	negative
con#rencor	negative
consagración	positive
consagrados	positive
consagrar	positive
consagrarse	positive
consciencia	positive
consecuentemente	positive
consecuente	positive
conseguir	positive
con#seguridad	positive
consenso	positive
consentido	negative
consentimiento	positive
consideracion	positive
consideración	positive
consideradamente	positive
considerado	positive
considerar	positive
consolación	positive
consolador	positive
consolar	positive
consolidar	positive
con#soltura	positive
conspiración	negative
conspirador	negative
conspirar	negative
constancia	positive
constante	positive
consternación	negative
consternado	negative
consternar	negative
constreñimiento	negative
constreñir	negative
constructivo	positive
consuelo	positive
consumado	positive
consumar	positive
contagiar	negative
contagioso	negative
contaminación	negative
contaminado	negative
contaminar	negative
contar#con	positive
contemporizar	positive
contencioso	negative
con#tendencia#alcista	positive
contentar	positive
contentísimo	positive
contento	positive
contestar#con#evasivas	negative
contienda	negative
contigo#pan#y#cebolla	negative
continuidad	positive
contradecir	negative
contradiccion	negative
contradicción	negative
contradictorio	negative
contraerse	negative
contra	negative
contraproducente	negative
contrariado	negative
contrariar	negative
contrariedad	negative
contrario	negative
contratiempo	negative
contravenir	negative
contribución	positive
contrición	negative
contristar	negative
contrito	negative
controversia	negative
controvertido	negative
contundente	positive
conturbar	negative
contusionar	negative
contusionarse	negative
contusion	negative
contusión	negative
convencer	positive
convenientemente	positive
conveniente	positive
convenio	positive
convenir#a	positive
convicción	positive
convidar	positive
convincentemente	positive
convincente	positive
convite	positive
convulsión	negative
cool	positive
cooperador	positive
cooperar	positive
cooperativamente	positive
cooperativo	positive
copete	negative
copiosamente	positive
copiosidad	positive
copioso	positive
coqueto	positive
coraje	positive
corajudo	negative
corazón	positive
córcholis	negative
cordialidad	positive
cordialmente	positive
cordial	positive
cordura	positive
cornucopia	positive
corrección	negative
correccion	positive
correctamente	positive
correctísimo	positive
correcto	positive
corregir	positive
correr#malos#vientos	negative
correr#un#tupido#velo	negative
corriente#y#moliente	negative
corroer	negative
corromper	negative
corromperse	negative
corrompido	negative
corrosión	negative
corrosivo	negative
corrupcion	negative
corrupción	negative
corrupto	negative
cortado	negative
cortante	negative
cortar#las#alas	negative
cortar	negative
cortar#por#lo#sano	negative
cortedad	negative
cortejar	positive
cortesía	positive
cortesmente	positive
cortésmente	positive
cortes	positive
cortés	positive
corto	negative
coser#y#cantar	positive
cosquillear	positive
cosquilleo	positive
costar#caro	negative
costar#dios#y#ayuda	negative
costar	negative
costar#un#huevo	negative
costar#un#ojo#de#la#cara	negative
costar#un#riñón	negative
costear	positive
costoso	negative
cotilla	negative
crack	positive
craso	negative
creativamente	positive
creatividad	positive
creativo	positive
crecer	positive
creciente	positive
crecimiento#negativo	negative
credibilidad	positive
crédulo	negative
creible	positive
creíble	positive
creído	negative
crespo	negative
criando#malvas	negative
criatura	negative
crimen	negative
criminal	negative
crisis#económica	negative
crisis	negative
crispar	negative
cristalino	positive
criterio	positive
crítica	negative
criticar	negative
crítico	negative
crónico	negative
crucial	positive
crucificar	negative
crudeza	negative
crueldad	negative
cruelmente	negative
cruel	negative
cruento	negative
cruzar#de#brazos	negative
cuadrar	positive
cualificado	positive
cuando#las#ranas#críen#pelo	negative
cuasirealista	negative
cucaracha	negative
cuenta	negative
cuento	negative
cuerdo	positive
cuestionable	negative
cuestionar	negative
cuidado	positive
cuidadosamente	positive
cuidadoso	positive
cuidar	positive
cuitado	negative
cuita	negative
culminación	positive
culpabilidad	negative
culpable	negative
culpado	negative
culpa	negative
culpar	negative
culposo	negative
cultivado	positive
culto	positive
cultural	positive
cumbre	positive
cumpleaños	positive
cumplido	positive
cumplimentar	positive
cumplimiento	positive
cumplir#con	positive
cumplir	positive
curar	positive
curarse	positive
curiosamente	positive
curioso	positive
currados	positive
cutre	negative
Cutre	negative
cutrez	negative
dabuten	positive
dabuti	positive
dadivoso	positive
danar	negative
dañar	negative
danino	negative
dañino	negative
daño#colateral	negative
dano	negative
daño	negative
danoso	negative
daños#y#perjuicios	negative
dantesco	negative
danza	positive
dar#asco	negative
dar#calabazas	negative
dar#confianza#a	positive
dar#con#la#puerta#en#las#narices	negative
dar#con#un#canto#en#los#dientes	negative
dar#ejemplo#a	positive
dar#el#batacazo	negative
dar#el#brazo#a#torcer	negative
dar#el#cantazo	negative
dar#el#cante	negative
dar#el#coñazo	negative
dar#el#visto#bueno#a	positive
dar#en#bandeja	positive
dar#en#el#clavo	positive
dar#esquinazo	negative
dar#gato#por#liebre	negative
dar#gusto	positive
dar#la#bienvenida#a	positive
dar#la#cara	positive
dar#la#espalda	negative
dar#la#lata	negative
dar#la#nota	negative
dar#la#razón	positive
dar#las#gracias#a	positive
dar#la#tabarra#a	negative
dar#más#guerra#que#un#niño#chico	negative
dar#más#vueltas#que#una#noria	negative
dar#más#vueltas#que#una#peonza	negative
dar#más#vueltas#que#un#tonto	negative
dar#mucha#guerra	negative
dar#pal#pelo	negative
dar	positive
dar#razón	positive
dar#sopas#con#onda	negative
dar#una#bofetada#a	negative
dar#una#paliza#a	negative
dar#un#leñazo	negative
dar#un#palo	negative
dar#un#puñetazo#a	negative
dar#un#traspié	negative
dar#vela#en#este#entierro	negative
de#acuerdo	positive
de#alto#standing	positive
deambular#sin#rumbo	negative
debacle	negative
debatir	negative
deber#cumplido	positive
deber	negative
debilidad	negative
debilitador	negative
debilitar	negative
debilitarse	negative
debilmente	negative
debil	negative
débil	negative
debilucho	negative
de#boquilla	negative
de#buena#gana	positive
de#buen#augurio	positive
de#buen#rendimiento	positive
de#buen#ver	positive
decadencia	negative
decadente	negative
decaer	negative
decaido	negative
decaído	negative
decaimiento	negative
decapitar	negative
decencia	positive
decentemente	positive
decente	positive
decepcionado	negative
decepcionante	negative
Decepcionante	negative
decepcionar	negative
decepcion	negative
Decepcion	negative
DECEPCION	negative
decepción	negative
dechado	positive
decididamente	positive
decidido	positive
decir#palabrotas	negative
decir#por#activa#y#pasiva	negative
decisivo	positive
declarar#inhabitable	negative
declarar#inocente	positive
declinar	negative
de#coña	negative
decorativo	positive
decrépito	negative
decrepitud	negative
dedicación	positive
dedicar	positive
dedicatoria	positive
de#espíritu#competitivo	positive
de#fantasía	positive
defectivo	negative
defecto	negative
defectos	negative
defectuosamente	negative
defectuoso	negative
defender#como#un#gato#panza#arriba	negative
defender#como#un#león	positive
defender#con#uñas#y#dientes	positive
defender	positive
defensa	positive
defensor	positive
deferencia	positive
de#fiar	positive
deficiencia	negative
deficientemente	negative
deficiente	negative
deficit	negative
déficit	negative
definido	positive
definitivamente	positive
definitivo	positive
deformación	negative
deformar	negative
deforme	negative
defraudado	negative
defraudador	negative
defunción	negative
degeneracion	negative
degeneración	negative
degeneradamente	negative
degenerado	negative
degenerar	negative
degraciadamente	negative
degradación	negative
degradante	negative
degradar	negative
degustacion	positive
degustación	positive
degustar	positive
Dejadez	negative
dejado	negative
dejar#cicatriz	negative
dejar#ciego	negative
dejar#cojo	negative
dejar#confuso#a	negative
dejar#en#el#tintero	negative
dejar#en#la#estacada	negative
dejar#la#piel	positive
dejar#perplejo	negative
dejar#plantado	negative
dejar	positive
dejarse	negative
dejazón	negative
de#la#acera#de#enfrente	negative
delatar	negative
deleitar	positive
deleitarse	positive
deleite	positive
deléitese	positive
deleitoso	positive
deletereo	negative
delicadeza	positive
delicado	negative
delicia	positive
deliciosamente	positive
delicioso	positive
Delicioso	positive
delictivo	negative
delincuencia	negative
delincuente	negative
delirante	negative
delirio	negative
delito	negative
demacrado	negative
demagogia	negative
de#mala#calidad	negative
de#mala#gana	negative
de#mal#agüero	negative
de#mala#manera	negative
de#mala#reputación	negative
de#mal#en#peor	negative
de#mal#gusto	negative
demasiado	negative
de#medio#pelo	negative
demencia	negative
demente	negative
de#milagro	positive
democrático	positive
de#modo#sospechoso	negative
demoledor	negative
demoler	negative
demonio	negative
demonios	negative
demontre	negative
denegacion	negative
denegación	negative
denegar	negative
denigrar	negative
densamente	negative
denso	negative
denunciable	negative
denuncia	negative
denunciar	negative
de#oro	positive
de#perdidos#al#río	negative
deplorablemente	negative
deplorable	negative
Deplorable	negative
deplorar	negative
de#poca#confianza	negative
depravación	negative
depravado	negative
depravar	negative
de#precisión	positive
depre	negative
depresion	negative
Depresion	negative
depresión	negative
depresivo	negative
deprimentemente	negative
deprimente	negative
de#primera#clase	positive
de#primera	positive
deprimido	negative
deprimir	negative
derecho	positive
deriva	negative
derribado	negative
derribar	negative
derribarse	negative
derrocar	negative
derrochador	negative
derrochar	negative
derroche	negative
derrota	negative
derrotar	negative
derruido	negative
derrumbamiento	negative
derrumbarse	negative
desabrido	negative
desabrigo	negative
desacato	negative
desaceleración	negative
desacertadamente	negative
desacertado	negative
desaconsejable	negative
desaconsejar	negative
desacreditar	negative
desacuerdo	negative
desafecto	negative
desafiantemente	negative
desafiante	negative
desafiar	negative
desafilado	negative
desafinar	negative
desafio	negative
desaforo	negative
desafortunadamente	negative
desafortunado	negative
desagradablemente	negative
desagradable	negative
desagradar	negative
desagradecido	negative
desagrado	negative
desagraviar	positive
desahogo	positive
desahuciar	negative
desairar	negative
desaire	negative
desalentadamente	negative
desalentado	negative
desalentadoramente	negative
desalentador	negative
desalentar	negative
desaliento	negative
desaliñado	negative
desaliñar	negative
desalmado	negative
desalojar	negative
desamor	negative
desamparado	negative
desamparar	negative
desamparo	negative
desangrar	negative
desanimadamente	negative
desanimado	negative
desanimar	negative
desánimo	negative
desapaciblemente	negative
desapacible	negative
desaparecer	negative
desaparición	negative
desaprobación	negative
desaprobar	negative
desaprovechado	negative
desaprovechar	negative
desaquellar	negative
desarmar	negative
desarmarse	negative
desarraigar	negative
desarrapado	negative
desarreglo	negative
desarrollar	positive
desarrollo	positive
desasosegado	negative
desasosegar	negative
desasosiego	negative
desastrado	negative
desastre	negative
desastrosamente	negative
desastroso	negative
Desastroso	negative
desatascar	positive
desatascarse	positive
desatento	negative
desavenencia	negative
desazonar	negative
desazon	negative
desazón	negative
desbandada	negative
desbandarse	negative
desbarajuste	negative
desbaratar	negative
desbordamiento	negative
descabelladamente	negative
descabellado	negative
descaecimiento	negative
descansar	positive
descanso	positive
descaradamente	negative
descarado	negative
descargar	positive
descaro	negative
descenso	negative
descomponer	negative
descomponerse	negative
descomposición	negative
descomposicón	negative
descompuesto	negative
descomunal	negative
desconcertado	negative
desconcertante	negative
desconcertar	negative
desconcierto	negative
desconfiadamente	negative
desconfiado	negative
desconfianza	negative
desconfiar#de	negative
desconfiar	negative
desconocidamente	negative
desconocido	negative
desconsiderado	negative
desconsoladamente	negative
desconsolado	negative
desconsolador	negative
desconsolar	negative
desconsuelo	negative
descontentar	negative
descontento	negative
descorazonamiento	negative
descorazonar	negative
descortesmente	negative
descortes	negative
descortés	negative
descrédito	negative
descreído	negative
descuajar	negative
descubrimiento	positive
descubrir#el#pastel	negative
descubrir#la#pólvora	negative
descuello	negative
descuidado	negative
descuidar	negative
descuido	negative
desdenar	negative
desdeñar	negative
desden	negative
desdén	negative
desdeñosamente	negative
desdeñoso	negative
desdichado	negative
desdicha	negative
deseable	positive
deseado	positive
desear	positive
desechado	negative
desecho	negative
desechos	negative
desempeñar	positive
desempeño	positive
desencadenamiento	negative
desencajado	negative
desencaminado	negative
desencantar	negative
desencanto	negative
desenfrenado	negative
desengano	negative
desengaño	negative
desenmarañar	negative
desenmarañarse	negative
de#sentido#común	positive
desentonar	negative
desenvoltura	positive
deseo	positive
deseoso	positive
desequilibrado	negative
desequilibrio	negative
deserción	negative
desertar	negative
desesperacion	negative
desesperación	negative
desesperadamente	negative
desesperado	negative
desesperante	negative
Desesperante	negative
desesperanzadamente	negative
desesperanza	negative
desesperanzar	negative
desesperar	negative
desesperarse	negative
desestabilizar	negative
desestimacion	negative
desestimar	negative
desestimular	negative
desfachatez	negative
desfallecer	negative
desfallecimiento	negative
desfasado	negative
desfavorable	negative
desfavorecido	negative
desfigurar	negative
desgana	negative
desganar	negative
desgarbado	negative
desgarrado	negative
desgarrador	negative
desgarrar	negative
desgarro	negative
desgastar	negative
desgaste	negative
desgraciadamente	negative
desgraciado	negative
desgracia	negative
desgraciar	negative
desguazar	negative
deshacer	negative
desharrapado	negative
deshecho	negative
desheredar	negative
deshilachado	negative
deshincharse	negative
deshonestamente	negative
deshonestidad	negative
deshonesto	negative
deshonra	negative
deshonrar	negative
desierto	negative
desigualdad	negative
desigual	negative
desilusionar	negative
desilusion	negative
desilusión	negative
Desilusión	negative
desinflar	negative
desintegración	negative
desintegrar	negative
desintegrarse	negative
desinteresado	positive
desistir	negative
desleal	negative
deslealtad	negative
desliz	negative
deslucir	negative
deslumbrado	negative
deslumbramiento	positive
deslumbrante	negative
deslumbrar	positive
deslustrar	negative
deslustrarse	negative
desmadejado	negative
desmalazado	negative
desmanado	negative
desmán	negative
desmayadamente	negative
desmayado	negative
desmayar	negative
desmayarse	negative
desmedido	negative
desmedrar	negative
desmentir	negative
desmesurado	negative
desmesurar	negative
desmoralización	negative
desmoralizador	negative
desmoralizante	negative
desmoralizar	negative
desmoronamiento	negative
desmoronar	negative
desmoronarse	negative
desmotivar	negative
desnudar	negative
desobedecer	negative
desobediencia	negative
desobediente	negative
desocupado	positive
desolación	negative
desoladamente	negative
desolado	negative
desolar	negative
desorbitado	negative
desorbitar	negative
desordenado	negative
desordenar	negative
desorden	negative
desorganización	negative
desorganizado	negative
desorganizar	negative
desorientado	negative
desorientar	negative
desorvitados	negative
despachar#rápidamente	negative
despacio	negative
despacito#y#buena#letra	positive
despavorir	negative
despecho	negative
despectivamente	negative
despectivo	negative
despedazar	negative
despedida	negative
despedido	negative
despedir#a#la#francesa	negative
despedir	negative
despeinar	negative
despejado	positive
despejar	positive
despejarse	positive
despeluznante	negative
despeluznar	negative
despenar	positive
desperdiciar	negative
desperdicio	negative
desperfecto	negative
despertar	positive
despiadadamente	negative
despiadado	negative
despido	negative
despilfarrar	negative
despilfarro	negative
despistado	negative
despistar	negative
despitorrarse	negative
desplacer	negative
desplazar	negative
desplomarse	negative
despojar	negative
desposeer	negative
déspota	negative
despoticamente	negative
despótico	negative
despotismo	negative
despreciable	negative
despreciado	negative
despreciar	negative
despreciativamente	negative
despreciativo	negative
desprecio	negative
desprendido	positive
despreocupación	negative
desprestigiar	negative
desprivar	negative
desproporcionado	negative
despropósito	negative
despropositos	negative
desprotección	negative
desprotegido	negative
desprovisto	negative
desquicia	negative
desquiciante	negative
desquiciar	negative
desquite	negative
desregulación	negative
destacable	positive
destacadamente	positive
destacado	positive
destacar	positive
destacarse	positive
destartalado	negative
destemplar	negative
desterrado	negative
desterrar	negative
destierro	negative
destreza	positive
destripado	negative
destripar	negative
destrozada	negative
destrozar	negative
destrozo	negative
destrucción	negative
destructivo	negative
destructor	negative
destruir	negative
desvalido	negative
desvalorizar	negative
desvanecer	negative
desvanecimiento	negative
desvariar	negative
desvarío	negative
desvencijado	negative
desventaja	negative
desventajoso	negative
desventurado	negative
desventura	negative
desvergonzadamente	negative
desvergonzado	negative
desverguenza	negative
desvergüenza	negative
desviación	negative
desviarse	negative
desvirtuar	negative
detalladamente	positive
detallado	positive
detallista	positive
detención	negative
detener	negative
detenido	negative
deteriorar	negative
deteriorarse	negative
deterioro	negative
determinación	positive
determinado	positive
detestablemente	negative
detestable	negative
detestación	negative
detestar	negative
de#tomo#y#lomo	negative
detonador	negative
detrimento	negative
deuda	negative
devaluar	negative
devastadoramente	negative
devastador	negative
devastar	negative
devoción	positive
devolver	negative
devoto	positive
diaaaaaas	positive
diaaaaas	positive
diaaaas	positive
diaaas	positive
diaaasss	positive
diaas	positive
diablillo	negative
diablo	negative
diablos	negative
diabolicamente	negative
diabólicamente	negative
diabólico	negative
diantre	negative
diantres	negative
diarrea	negative
diass	positive
diasss	positive
diassss	positive
diasssss	positive
diatriba	negative
dicha	positive
dichosamente	positive
dichoso	positive
dictador	negative
dictadura	negative
dictatorial	negative
diestramente	positive
diestro	positive
difamación	negative
difamar#a	negative
difamar	negative
difamatoriamente	negative
difamatorio	negative
difícil#de#manejar	negative
dificilísimo	negative
difícilmente	negative
dificil	negative
Dificil	negative
difícil	negative
dificultad	negative
dificultar	negative
dificultoso	negative
difunto	negative
difuso	negative
dignarse	negative
dignidad	positive
dignificar	positive
digno#de#confianza	positive
digno#de#mención	positive
digno	positive
diias	positive
diiias	positive
diiiias	positive
dilatada#experiencia	positive
dilatado	positive
dilección	positive
dilema	negative
diligencia	positive
diligentemente	positive
diligente	positive
diluvio	negative
dimisión	negative
dimitir	negative
dinamico	positive
dinámico	positive
diñarla	negative
dios	negative
diplomático	positive
directamente	positive
directo	positive
discernimiento	positive
disciplinado	positive
disconformidad	negative
discordante	negative
discordia	negative
discrecion	positive
discreción	positive
discrepancia	negative
discrepar	negative
discretamente	positive
discreto	positive
discriminación	negative
discriminar	negative
disculpar	negative
discusion	negative
discusión	negative
discutible	negative
discutir	negative
diseminado	negative
disensión	negative
disentir	negative
diserto	positive
disfruta	positive
disfrutar#de	positive
disfrutar#plenamente	positive
disfrutar	positive
disfrute	positive
disfuncional	negative
disgustado	negative
disgustar	negative
disgusto	negative
dislocar	negative
disminución	negative
disminuir	negative
disolución	negative
disolver	negative
disolverse	negative
disparar	negative
disparatadamente	negative
disparatado	negative
disparate	negative
displacer	negative
disponible	positive
dispuesto	positive
disputa	negative
disputar	negative
distanciamiento	negative
distante	negative
distincion	positive
distinción	positive
distinguido	positive
distinguir	positive
distinguirse	positive
distintivo	positive
distorsionar	negative
distracción	negative
distraer	negative
distraído	negative
disturbios	negative
disuadir	negative
disuasivo	negative
diver	positive
diversión	positive
diverso	negative
divertidamente	positive
divertidísimamente	positive
divertidísimo	positive
divertido	positive
divertir#como#un#enano	positive
divertir	positive
dividir	negative
dividirse	negative
divinamente	positive
divinidad	positive
divinizar	positive
divino	positive
división	negative
divisorio	negative
divorciar	negative
divorciarse	negative
divorcio	negative
doblado	negative
docto	positive
dogmático	negative
dolencia	negative
doler	negative
dolido	negative
doliente	negative
dolor#de#cabeza	negative
doloridamente	negative
dolorido	negative
dolor#insoportable	negative
dolor#muy#agudo	negative
dolor	negative
dolorosamente	negative
doloroso	negative
doloso	negative
dominante	negative
dominar	positive
dominio	positive
donaire	positive
donar	positive
donde#dije#digo#digo#diego	negative
donde#las#dan#las#toman	negative
don	positive
dopar	negative
dos#son#compañía;#tres#son#multitud	negative
dotado	positive
dotar	positive
drástico	negative
droga	negative
ducho	positive
duda	negative
dudar#de	negative
dudar	negative
dudosamente	negative
dudoso	negative
duelo	negative
dulcemente	positive
dulce#navidad	positive
dulce	positive
dulces#sueños	positive
dulzura	positive
durable	positive
duradero	positive
duramente	negative
durar	positive
durísimo	negative
duro	negative
ebrio	negative
echador	negative
echar#a#la#calle	negative
echar#a#perder	negative
echar#balones#fuera	negative
echar#chispas	negative
echar#cuento	negative
echar#de#menos	negative
echar#en#brazos	negative
echar#en#falta	negative
echar#huevos	positive
echar#la#culpa#a	negative
echar#las#campanas#al#vuelo	negative
echar#leña#al#fuego	negative
echar#más#leña#al#fuego	negative
echar	negative
echar#pestes	negative
echar#sal#en#la#herida	negative
echar#sapos#y#culebras#por#la#boca	negative
echarse#a#perder	negative
echar#toda#la#carne#al#asador	positive
echar#toda#la#carne#en#el#asador	positive
echar#una#mano	positive
echar#una#reprimenda#a	negative
echar#un#rapapolvo	negative
ecológico	positive
económico	positive
edicion	positive
edificante	positive
edificar	positive
educado	positive
educar	positive
educativo	positive
efectividad	positive
efectivo	positive
eficacia	positive
eficazmente	positive
eficaz	positive
eficiencia	positive
eficiente	positive
efimero	negative
efímero	negative
efusión	positive
efusivamente	positive
efusivo	positive
egocéntrico	negative
egoísmo	negative
egoistamente	negative
egoísta	negative
egregio	negative
Egunon	positive
ejem	negative
ejemplar	positive
ejemplo	positive
elacion	negative
elección	positive
electrizar	positive
elegancia	positive
elegantemente	positive
elegante	positive
Elegante	positive
elevadísimo	negative
elevado	positive
elevar	positive
eliminación	negative
eliminar	negative
elite	positive
el#menos	negative
elocuencia	positive
elocuentemente	positive
elocuente	positive
elogiar	positive
elogio	positive
elogioso	positive
el#papel#lo#aguanta#todo	negative
el#que#la#sigue#la#consigue	positive
el#que#lo#huele#debajo#lo#tiene	negative
el#que#no#se#consuela#es#porque#no#quiere	negative
eludir	negative
emancipar	positive
embarazosamente	negative
embarazoso	negative
embaucar	negative
embebecer	positive
embelesado	positive
embelesamiento	positive
embelesar	positive
embeleso	positive
embellecer	positive
embestir	negative
emblemático	positive
embobar	positive
emborrachar	positive
emboscada	negative
embotado	negative
embozar	negative
embravecer	negative
embravecido	negative
embriagar	positive
embrollo	negative
embromar	positive
embrujar	positive
embrujo	positive
embrutecer	negative
embullo	positive
embuste	negative
embutir	negative
eminencia	positive
eminentemente	positive
emocionado	positive
emocionantemente	positive
emocionante	positive
emocionar	positive
emocionarse	positive
emoción	positive
emotivas#imágenes	positive
emotivo	positive
empalagamiento	negative
empalagar	negative
empalagoso	negative
empanado	negative
empañar	negative
emparanoiado	negative
empatía	positive
empático	positive
empeño	positive
empeoramiento	negative
empeorar	negative
empeorarse	negative
emperrarse	negative
emplear#mal	negative
empobrecer	negative
empobrecido	negative
empobrecimiento	negative
emponzoñar	negative
emporcar	negative
emprendedor	positive
empresa#arriesgada	negative
empuje	positive
enajenación	negative
enajenar	negative
enaltecer	positive
enamoramiento	positive
enamorar	positive
enano	negative
encabritar	negative
encajar#con	positive
encajar#en	positive
encajar	positive
encalabrinar	negative
en#calma	positive
encalmar	positive
encantadísimo	positive
encantado	positive
encantadoramente	positive
encantador	positive
Encantador	positive
encantar	positive
encanto	positive
encaprichado	negative
encarcelar	negative
encarecidamente	negative
encender#la#bombilla	positive
enchufismo	negative
enclenque	negative
encocorar	negative
encoger	negative
encogerse#de#hombros	negative
encogerse	negative
encogimiento#de#hombros	negative
encolerizar	negative
encomendar	positive
encomiable	positive
encomiar	positive
enconadamente	negative
enconado	negative
enconar	negative
en#condiciones	positive
encono	negative
en#consonancia	positive
encontronazo	negative
encorajinar	negative
encorsetado	negative
encuitar	negative
enculado	negative
endeble	negative
endeblez	negative
endemoniar	negative
endeudar#hasta#las#cejas	negative
endeudar	negative
endiosamiento	negative
endiosar	positive
endulzar	positive
enemigo	negative
enemistad	negative
enemistarse#con	negative
enemistoso	negative
energía	positive
enérgicamente	positive
enérgico	positive
energizar	positive
enervar	negative
enfadadamente	negative
enfadado	negative
enfadar	negative
enfadarse	negative
enfado	negative
enfadoso	negative
enferma	negative
enfermar	negative
enfermedad	negative
enfermizo	negative
enfermo	negative
enfierecido	negative
enflaquecer	negative
enfrentamiento	negative
enfrentar	negative
enfriar	negative
enfurecer	negative
enfurecido	negative
enfurecimiento	negative
enfurruñamiento	negative
enfurruñarse	negative
engañabobos	negative
engañar	negative
enganchado	negative
engañifa	negative
engano	negative
engaño	negative
Engaño	negative
engañosamante	negative
enganoso	negative
engañoso	negative
enganza	negative
engativamente	negative
engatusar	negative
engendro	negative
engorro	negative
engorroso	negative
engrandecer	positive
engreído	negative
engreimiento	negative
enhorabuena	positive
Enhorabuena	positive
enjaulado	negative
enjuiciar	negative
enlatado	negative
enlatados	negative
en#lo#alto	positive
enloquecedor	negative
enloquecer	negative
enloquecido	negative
enloquecimiento	negative
enlutar	negative
en#mal#estado	negative
enmarañar	negative
ennegrecer	negative
ennoblecer	positive
enojadizo	negative
enojado	negative
enojamiento	negative
enojar	negative
enojo	negative
enojosamente	negative
enojoso	negative
enorabuena	positive
enorgullecer	positive
enormemente	positive
enorme	positive
enrabiar	negative
enrabietar	negative
enredar	negative
enredarse	negative
enredo	negative
enriquecer	positive
enrollada	positive
enrollado	positive
ensañamiento	negative
ensañar	negative
ensangrentado	negative
enseñar#los#colmillos	negative
enseñar#los#dientes	negative
enseriar	negative
ensombrecer	negative
ensuciar	negative
ensuciarse	negative
ensueño	positive
entender#mal	negative
entender	positive
entendido	positive
enternecimiento	positive
entono	negative
entorno#privilegiado	positive
entorpecer	negative
entrada	positive
entrañable#familia	positive
entranable	positive
entrañable	positive
entrañables#fiestas	positive
entraña	positive
entrar#como#un#elefante#en#una#cacharrería	negative
entrar#por#la#fuerza#en	negative
entrar	positive
entregar	positive
entremetido	negative
entretener	positive
entretenidamente	positive
entretenidísimo	positive
entretenido	positive
entretenimiento	positive
entristecedor	negative
entristecer	negative
entristecerse	negative
entristecimiento	negative
entrometerse	negative
entrometido	negative
entuerto	negative
entumecer	negative
entumecido	negative
entusiasmado	positive
entusiasmar	positive
entusiasmarse#por	positive
entusiasmarse	positive
entusiasmo	positive
entusiastamente	positive
entusiasta	positive
entusiástico	positive
envalentonamiento	negative
envanecimiento	negative
envenenar	negative
envidiable	positive
envidia	negative
envidiar	negative
envidiosomante	negative
envidioso	negative
envilecer	negative
enzarzar	negative
épico	positive
epidemia	negative
epítome	positive
epopeya	positive
equilibrio	positive
equitativamente	positive
equitativo	positive
equivalencia	positive
equivocacion	negative
equivocación	negative
equivocadamente	negative
equivocado	negative
equivocar	negative
equivocarse	negative
equívoco	negative
eres	negative
ergonómicamente	positive
ergonómico	positive
erosionar	negative
erótico	positive
erradicar	negative
errar	negative
erroneamente	negative
erróneamente	negative
erroneo	negative
erróneo	negative
error	negative
erudito	positive
erupcion	negative
esbelto	positive
escabechina	negative
escabroso	negative
escalada#de#violencia	negative
escalofriante	negative
escalofrío	negative
escandalizar	negative
escándalo	negative
escandalosamente	negative
escandaloso	negative
escaramuza	negative
escarmentar	negative
escasamente	negative
Escasa	negative
escasez	negative
Escasez	negative
escasísimamente	negative
escasísimo	negative
escaso	negative
Escaso	negative
escatológico	negative
escenas#dantescas	negative
escindirse	negative
escisión	negative
esclavitud	negative
esclavizar	negative
esclavo	negative
escoñar	negative
esconder	negative
escoria	negative
escoriar	negative
escozor	negative
escribir#peor#que#un#médico	negative
escrúpulo	positive
escrupulosamente	positive
escudar	negative
escupir	negative
escurrir#el#bulto	negative
esencial	positive
esforzado	positive
esmerado	positive
esmero	positive
espabilado	positive
espacioso	positive
espantable	negative
espantadizo	negative
espantar	negative
espantarsemente	negative
espantarse	negative
espanto	negative
espantosamente	negative
espantoso	negative
especialmente	positive
especial	positive
espectacularmente	positive
espectacular	positive
espejismo	negative
espeluznante	negative
espeluznar	negative
esperanzadamente	positive
esperanzado	positive
esperanza	positive
esperpéntico	negative
esperpento	negative
espicharla	negative
espina	negative
espinoso	negative
espiral#de#violencia	negative
espiritual	positive
espiritu	negative
esplendidamente	positive
espléndidamente	positive
esplendido	positive
espléndido	positive
esplendoroso	positive
esplendor	positive
esplín	negative
esquisita	positive
esquisito	positive
esquizofrénico	negative
estabilidad	positive
estabilizar	positive
estabilizarse	positive
establecido	positive
estable	positive
estafador	negative
estafa	negative
Estafa	negative
estafar	negative
estallar	negative
estampida	negative
estancado	negative
estancarse	negative
estar#a#dos#velas	negative
estar#a#favor#de	positive
estar#a#la#greña	negative
estar#a#la#que#salta	negative
estar#a#matar	negative
estar#como#dios	positive
estar#como#una#cabra	negative
estar#como#una#chota	negative
estar#como#una#regadera	negative
estar#como#un#cencerro	negative
estar#de#acuerdo	positive
estar#de#los#nervios	negative
estar#de#mal#humor	negative
estar#de#más	negative
estar#de#muerte	positive
estar#de#rechupete	positive
estar#en#ascuas	negative
estar#en#auge	positive
estar#en#babia	negative
estar#encantado#de#conocer	negative
estar#en#conflicto	negative
estar#en#la#inopia	negative
estar#en#la#luna	negative
estar#en#la#onda	positive
estar#en#las#nubes	negative
estar#en#las#últimas	negative
estar#en#off#side	negative
estar#en#su#mano	negative
estar#en#todo	negative
estar#entre#la#espada#y#la#pared	negative
estar#entre#pinto#y#valdemoro	negative
estar#harto	negative
estar#hasta#el#coño	negative
estar#hasta#el#gorro	negative
estar#hasta#el#moño	negative
estar#hasta#la#cocorota	negative
estar#hasta#la#coronilla	negative
estar#hasta#las#narices	negative
estar#hasta#las#pelotas	negative
estar#hasta#los#cojones	negative
estar#hasta#los#huevos	negative
estar#hecho#polvo	negative
estar#loco#de#atar	negative
estar#loco#de#contento	positive
estar#loco#de#remate	negative
estar#mal#de#la#azotea	negative
estar#mal#de#la#cabeza	negative
estar#más#aburrido#que#loco#recién#lavado	negative
estar#más#a#gusto#que#un#arbusto	positive
estar#más#buena#que#el#pan	positive
estar#más#colgado#que#un#cuadro	negative
estar#más#contento#que#ni#sé	positive
estar#más#contento#que#unas#pascuas	positive
estar#más#contento#que#un#niño#con#zapatos#nuevos	positive
estar#más#enredado#que#un#bulto#de#anzuelos	negative
estar#más#gorda#que#una#ballena	negative
estar#más#gorda#que#una#foca	negative
estar#más#gordo#que#un#tonel	negative
estar#más#hambriento#que#león#de#circo	negative
estar#más#limpio#que#una#patena	positive
estar#montado#en#el#dólar	positive
estar#muerto#de#cansancio	negative
estar#muy#puesto#en#un#tema	positive
estar#pallá	negative
estar#para#comer	positive
estar#para#el#arrastre	negative
estar#para#que#te#encierren	negative
estar#patas#arriba	negative
estar#pensando#en#las#musarañas	negative
estar#que#echas#chispas	negative
estar#que#muerdes	negative
estar#que#te#subes#por#las#paredes	negative
estar#rascándose#las#pelotas	negative
estar#roto	negative
estar#sembrado	positive
estar#tocado	negative
estar#todo#el#pescado#vendido	negative
estar#zumbado	negative
estelar	positive
esteril	negative
estéril	negative
estéticamente	positive
estiércol	negative
estigma	negative
estilisticamente	positive
estilizado	positive
estimado	positive
estima	positive
estimar	positive
estimulantemente	positive
estimulante	positive
estimular	positive
estímulo	positive
estirado	negative
estirar#la#pata	negative
estola	negative
estorbar#más#que#marrano#en#la#cocina	negative
estorbar	negative
estorbo	negative
estrafalario	negative
estragar	negative
estrago	negative
estragos	negative
estrambotico	negative
estrañare	negative
estrangular	negative
estrecharse#la#mano	negative
estrella	positive
estrellar	negative
estrellarse	negative
estremecedor	negative
estremecer	positive
estremecerse	negative
estrenar	positive
estreno	positive
estrépito	negative
estrepitosamente	negative
estresado	negative
estresante	negative
estricto	negative
estridente	negative
estropeado	negative
estropear	negative
estropearse	negative
estruendo	negative
estruendoso	positive
estudiado	negative
estudioso	positive
estupefacto	negative
estupendamente	positive
Estupenda	positive
estupendo	positive
Estupendo	positive
estupidamente	negative
estúpidamente	negative
estupidez	negative
estupido	negative
estúpido	negative
estupor	negative
etarra	negative
ético	positive
euforia	positive
euforicamente	positive
euforico	positive
eufórico	positive
euforizante	positive
eureka	positive
evadir	negative
evaluación	positive
evasivo	negative
evocador	positive
exabrupto	negative
exacerbación	negative
exacerbante	negative
exacerbar	negative
exacto	positive
exageración	negative
exageradamente	negative
exagerado	negative
exagerar	negative
exaltado	positive
exaltar	positive
exasperación	negative
exasperante	negative
exasperar	negative
excandecencia	negative
exceder	positive
excelencia	positive
excelentemente	positive
excelente	positive
Excelentes	positive
excelentísimo	positive
excentricidad	negative
excentrico	negative
excéntrico	negative
excepcionalmente	positive
excepcional	positive
Excepcional	positive
excepción	negative
excesivamente	negative
excesivo	negative
exceso	negative
excitante	positive
excitar	positive
exclamar	negative
excluir	negative
exclusión	negative
exclusivo	positive
excremento	negative
exculpar	positive
excusa	negative
execrablemente	negative
execrable	negative
execracion	negative
execrar	negative
exelente	positive
Exelente	positive
exencion	positive
exhortar	negative
exigente	negative
exiguidad	negative
exiguo	negative
exiliado	negative
exiliar	negative
exilio	negative
éxito	positive
exitoso	positive
exonerar	positive
exorbitante	negative
exorcismo	negative
exótico	positive
expansivo	positive
expectación	positive
expectaculares	positive
expectacular	positive
expectativa	positive
experiencia#increíble	positive
experiencia#inolvidable	positive
experiencia#única	positive
experimentado	positive
experto	positive
expirar	negative
explosión	negative
explosivo	negative
explotación	negative
explotador	negative
explotar	negative
expolio	negative
expresar#agradecimiento#por	positive
expresión	positive
expresivo	positive
expulsar	negative
expulsión	negative
exquisitamente	positive
exquisitez	positive
exquisito	positive
Exquisito	positive
extasiante	positive
extasiar	positive
éxtasis	positive
extático	positive
extensísimo	positive
extenso	positive
exterminacion	negative
exterminar	negative
exterminio	negative
extinción	negative
extinguir	negative
extirpar	negative
extorsionar	negative
extorsion	negative
extorsión	negative
extrañamente	negative
extrañar	negative
extrano	negative
extraño	negative
extraordinariamentemente	positive
extraordinariamente	positive
extraordinario	positive
extravagante	negative
extraviado	negative
extremista	negative
extremo	negative
exuberantemente	positive
exuberante	positive
exultacion	positive
exultante	positive
exultant	positive
exultar	positive
fabricación	negative
fabulosamente	positive
fabuloso	positive
Fabuloso	positive
facha	negative
facilidad	positive
facilísimo	positive
facilitar	positive
facilmente	positive
fácilmente	positive
facilón	negative
facil	positive
fácil	positive
Fácil	positive
facistol	negative
factible	positive
factura	negative
facultades	positive
facultar	positive
faena	negative
falacia	negative
falla	negative
fallar	negative
fallecer	negative
fallecimiento	negative
fallido	negative
fallo	negative
falsamente	negative
falsear	negative
falsedad	negative
falsificación	negative
falsificado	negative
falsificar	negative
falso	negative
falta#absoluta	negative
falta#de#consideración	negative
falta#de#higiene	negative
falta#de#honradez	negative
falta#de#limpieza	negative
falta#de#profesionalidad	negative
falta#de#respeto	negative
falta	negative
faltar	negative
faltar#una#neurona	negative
faltar#una#primavera	negative
faltar#un#hervor	negative
faltar#un#tornillo	negative
falto	negative
faltón	negative
fama	positive
familiaridad	positive
familiar	positive
famili	positive
famoso	positive
fanático	negative
fanfarron	negative
fantasía	positive
fantasma	negative
fantasticamente	positive
fantásticamente	positive
fantastica	positive
Fantástica	positive
Fantásticas	positive
fantastico	positive
Fantastico	positive
fantástico	positive
Fantástico	positive
fantoche	negative
farfulla	negative
farfullar	negative
farolero	negative
farol	negative
farra	positive
farsa	negative
farsante	negative
fascinación	positive
fascinado	positive
fascinantemente	positive
fascinante	positive
fascinar	positive
fascismo	negative
fascista	negative
fashion	positive
fastidiado	negative
fastidiante	negative
fastidiar	negative
fastidio	negative
fastidiosamente	negative
fastidioso	negative
fasto	positive
fastuosidad	positive
fastuoso	positive
fatalmente	negative
fatal	negative
fatidicamente	negative
fatídico	negative
fatiga	negative
fatigar	negative
fatigarse	negative
fatigoso	negative
fatuo	negative
fausto	positive
favorablemente	positive
favorable	positive
favorecedor	positive
favorecer	positive
favorecimiento	positive
favorito	positive
favor	positive
fealdad	negative
febril	negative
fecundo	positive
fehaciente	positive
feísimo	negative
felices#fiestas	positive
felicesfiestas	positive
felicidades	positive
Felicidades	positive
felicidad	positive
felicitaciones	positive
felicitación	positive
felicitar	positive
feliz#cumpleaños	positive
Feliz#Martes	positive
felizmente	positive
feliz	positive
Feliz	positive
fenecer	negative
fenomenalmente	positive
fenomenal	positive
feo	negative
fe	positive
feraz	positive
feria	positive
ferocidad	negative
ferozmente	negative
feroz	negative
fertil	positive
fértil	positive
ferviente	positive
fervorosamente	positive
fervoroso	positive
fervor	positive
festejo	positive
festejos	positive
festival	positive
festivo	positive
fetén	positive
fetiche	positive
fetidez	negative
fétido	negative
feto	negative
fiabilidad	positive
fiable	positive
fiasco	negative
Fiasco	negative
fibra	positive
ficticio	negative
fidedigno	positive
fidelidad	positive
fiebre	negative
fielmente	positive
fiel	positive
fiera	negative
fiereza	negative
fiesta	positive
fiestas	positive
figurarse	positive
fijacion	negative
fijar	positive
fila	negative
filantropo	positive
filonazis	negative
final	positive
finamente	positive
financiar	positive
fineza	positive
fingido	negative
fingimiento	negative
fingir	negative
fingirse	negative
fino	positive
firme	positive
fisgon	negative
fisura	negative
flagrantemente	negative
flagrante	negative
flamante#coche	positive
flamante	positive
flaquear	negative
flaqueza	negative
flébil	negative
flechar	positive
flexible	positive
flipada	positive
flipado	negative
flipar	negative
flojear	negative
flojo	negative
Flojo	negative
florecer	positive
floreciente	positive
fluido	positive
fobia	negative
fogosidad	positive
fogoso	positive
follar#menos#que#los#roper	negative
fomentar	positive
fomento	positive
fondo	positive
forajido	negative
forastero	negative
forcejear	negative
forcejeo	negative
forcejo	negative
formalidad	positive
formal	positive
formidable	negative
formulario	negative
forrado	positive
fortaleza	positive
fortísimo	positive
fortuna	positive
forzado	negative
forzar	negative
fracasadamente	negative
fracasado	negative
fracasar	negative
fracaso	negative
fractura	negative
fracturar	negative
fracturarse	negative
frágil	negative
francamente	positive
franco	positive
franquista	negative
fraternal	positive
fraternidad	positive
fraternizar	positive
fraude	negative
fraudulentamente	negative
fraudulento	negative
frenesi	negative
frenético	negative
fresco	positive
frescura	positive
friamente	negative
fricción	negative
frígido	negative
friolero	negative
frio	negative
frío	negative
Fritanga	negative
frívolo	negative
frondoso	positive
fructifero	positive
fructífero	positive
fructuoso	positive
frugalmente	positive
fruncir#el#ceño	negative
fruncir	negative
frustación	negative
frustración	negative
frustrado	negative
frustrar	negative
fruta#fresca	positive
fuera#de#peligro	positive
fuera	negative
fuero	negative
fuertemente	positive
fuerte	positive
fuerza#disuasoria	negative
fuerza	positive
fuga	negative
fugarse	negative
fugaz	negative
fugitivo	negative
fumar#más#que#la#pipa#de#un#indio	negative
fumar#más#que#un#carretero	negative
funcional	positive
fundamentalmente	positive
fundamental	positive
fúnebremente	negative
fúnebre	negative
funeral	negative
funerario	negative
funestamente	negative
funesto	negative
furcia#asquerosa	negative
furia	negative
furibundamente	negative
furibundo	negative
furiosamente	negative
furioso	negative
furor	negative
furtivamente	negative
furtivo	negative
furúnculo	negative
fustigar	negative
futilidad	negative
gacetillero	negative
galante	positive
galanteria	positive
gala	positive
galardon	positive
galimatías	negative
gallardo	positive
gallina	negative
gallito	negative
gamberro	negative
ganador	positive
ganancia	positive
gañán	negative
gana	positive
ganar#en#bruto	negative
ganar	positive
gandulear	negative
ganga	positive
gañido	negative
gañir	negative
garantía	positive
garantizado	positive
garantizar	positive
garboso	positive
garrula	negative
garrulo	negative
gases	negative
gastado	negative
gastar	negative
gastarse	negative
gasto	negative
gazapaton	negative
gazapo	negative
gelatinoso	negative
gema	positive
gemido	negative
gemir	negative
generalmente	positive
generar#sinergias	positive
género	positive
generosamente	positive
generosidad	positive
generoso	positive
genialmente	positive
genial	positive
Genial	positive
genio	positive
genocidio	negative
gentil	positive
genuino	positive
ghetto	negative
gigante	positive
gilimierdas	negative
gilipollas	negative
gilipollez	negative
glacial	negative
glamuroso	positive
gloria	positive
gloriar	positive
glorificar	positive
gloriosamente	positive
glorioso	positive
glotón	negative
goce	positive
golosina	positive
goloso	positive
golpear	negative
golpe	negative
gordo	negative
gorila	negative
gorrona	negative
gorronear	negative
gorrón	negative
gozada	positive
gozar#de	positive
gozar	positive
gozo	positive
gozosamente	positive
gozoso	positive
gracia	positive
gracias#amigo	positive
gracias#a	positive
gracias#de#corazon	positive
gracias#por#todo	positive
gracias	positive
Gracias	positive
GRACIAS	positive
gràcies	positive
Gràcies	positive
graciosamente	positive
graciosísimo	positive
gracioso	positive
gráficamente	negative
gráfico	negative
gran#ambiente	positive
gran#calidad	positive
gran#decepcion	negative
grande	positive
gran#descubrimiento	positive
grandeza	positive
grandiosidad	positive
grandioso	positive
grandísimo	positive
gran#experiencia	positive
gran#lugar	positive
gran#noche	positive
gran	positive
Gran	positive
gran#servicio	positive
gran#ubicación	positive
gran#variedad	positive
gratamente	positive
grata#sorpresa	positive
gratificacion	positive
gratificación	positive
gratificador	positive
gratificantemente	positive
gratificante	positive
gratificar	positive
gratis	positive
gratitud	positive
grato	positive
gratuitamente	positive
gratuito	positive
gratuíto	positive
gravedad	negative
gravemente	negative
grave	negative
grieta	negative
grima	negative
gris	negative
gritar	negative
grito	negative
grito#pelado	negative
Gritos	negative
groseramente	negative
groseria	negative
grosero	negative
grotescamente	negative
grotesco	negative
gruesamente	negative
gruesa	negative
gruñido	negative
gruñir	negative
grunon	negative
gruñón	negative
guácala	negative
guai	positive
gualá	negative
guantánamo	negative
guapamente	positive
guapetona	positive
guapisima	positive
guapísimo	positive
guapo	positive
guardar#como#un#tesoro	positive
guarreras	negative
guarrería	negative
guarrona	negative
guarro	negative
guasa	positive
guau	positive
guay#del#paraguay	positive
guay	positive
guerra	negative
gueto	negative
guiñar#el#ojo	positive
guiño	positive
gula	negative
gusano	negative
gustar	positive
gustazo	positive
gusto#exquisito	positive
gusto	positive
gustosamente	positive
gustoso	positive
haber#gato#encerrado	negative
habilidad	positive
habilmente	positive
hábilmente	positive
habil	positive
hábil	positive
habitación#amplia	positive
habitación#espaciosa	positive
habitación#grande	positive
hablar#por#hablar	negative
hablar#sin#parar	negative
hacer#como#si#no#existiese	negative
hacer#daño	negative
hacer#de#tripas#corazón	negative
hacer#digresiones	negative
hacer#el#estrecho	negative
hacer#el#indio	negative
hacer#el#longuis	negative
hacer#el#primo	negative
hacer#el#sueco	negative
hacer#el#tonto	negative
hacer#estragos	negative
hacer#imposible	negative
hacer#la#boca#agua	positive
hacer#la#cama	negative
hacer#la#picha#un#lío	negative
hacer#la#pirula	negative
hacer#la#vista#gorda	negative
hacer#leña#del#árbol#caído	negative
hacer#más#alegre	positive
hacer#mutis#por#el#foro	negative
hacer#naufragar	negative
hacer#novillos	negative
hacer#oídos#sordos	negative
hacer#pasar#hambre	negative
hacer#pipí	negative
hacer#por#cojones	negative
hacer#por#huevos	negative
hacer#por#las#buenas	negative
hacer#pucheros	negative
hacer#su#agosto	positive
hacer#temblar	negative
hacer#trampa	negative
hacer#trampas	negative
hacer#trizas	negative
hacer#una#cantada	negative
hacer#una#mueca#de#dolor	negative
hacer#una#tormenta#en#un#vaso#de#agua	negative
hacer#un#chantaje#a	negative
hacer#un#lío	negative
hacer#volar	negative
hacer#zozobrar	negative
hacha	positive
hacinar	negative
hahahaha	positive
halagar	positive
halago	positive
halagüeño	positive
hallazgo#sorprendente	positive
hambre	negative
hambriento	negative
hampon	negative
harapiento	negative
harpia	negative
hartar	negative
harto	negative
hasta#la#coronilla	negative
hastiado	negative
hastiar	negative
hastio	negative
hastío	negative
hastioso	negative
hay#que#joderse	negative
hazaña	positive
heavy	negative
hecatombe	negative
hechizar	positive
hechizo	positive
hecho#mierda	negative
hediondez	negative
hediondo	negative
hedor	negative
HEEY	positive
helado	negative
helador	negative
helar	negative
hematoma	negative
hereje	negative
herejía	negative
herida	negative
herido	negative
herir#en#lo#más#hondo	negative
herir	negative
hermandad	positive
hermosamente	positive
Hermosa	positive
hermoso	positive
hermosura	positive
héroe	positive
heroicamente	positive
heroicidad	positive
heroico	positive
heroína	positive
heroismo	positive
heroísmo	positive
hervir	negative
hiel	negative
hijo#de#puta	negative
hijodeputa	negative
hijoputa	negative
hijo#puta	positive
hilarantemente	positive
hilarante	positive
hilaridad	positive
hinchado	negative
hincha	negative
hinchazon	negative
hiperdeformado	negative
hiperpreocupado	negative
hipnotizar	positive
hipocresía	negative
hipocritamente	negative
hipócrita	negative
hiriente	negative
histeria	negative
histéricamente	negative
histérico	negative
histerismo	negative
historia	negative
hoja#de#reclamaciones	negative
holgado	positive
holgura	positive
hombre	negative
homenajear	positive
homenaje	positive
homicida	negative
homicidio	negative
homófobos	negative
hondo	positive
honestamente	positive
honesto	positive
hongos	negative
honorable	positive
honorado	positive
honor	positive
honradamente	positive
honradez	positive
honrado	positive
honra	positive
honrar	positive
honrosamente	positive
honroso	positive
horrendamente	negative
horrendo	negative
horriblemente	negative
horrible	negative
horrido	negative
hórrido	negative
horrificar	negative
horripilación	negative
horripilantemente	negative
horripilante	negative
horripilar	negative
horrísono	negative
horrorizado	negative
horrorizante	negative
horrorizar	negative
horror	negative
horrorosamente	negative
horroroso	negative
Horroroso	negative
hortera	negative
hosco	negative
hospitalario	positive
hospitalidad	positive
hostigador	negative
hostigar	negative
hostilidad	negative
hostilizar	negative
hostil	negative
hotelucho	negative
huelga	negative
huérfano	negative
hueva	negative
huevon	negative
huevón	negative
huidizo	negative
huir	negative
humanidad	positive
humanitarismo	positive
humildad	positive
humilde	positive
humillacion	negative
humillación	negative
humillante	negative
humillar	negative
humorismo	positive
humor	positive
hundido	negative
hundimiento	negative
hundir	negative
hundírsele	negative
hundirse	negative
huraño	negative
hurra	positive
hurtar	negative
hurto	negative
husmear	negative
idea#equivocada	negative
idealismo	positive
idealmente	positive
ideal	positive
idea	positive
identidad	positive
identificar	positive
idílico	positive
idilio	positive
idiota	negative
idolatrar	positive
ídolo	positive
ido	negative
idoneo	positive
idóneo	positive
ignominia	negative
ignominioso	negative
ignorancia	negative
ignorante	negative
ignorar	negative
igualado	positive
igualar	positive
igualarse	positive
igualdad	positive
igualitario	positive
ilegalmente	negative
ilegal	negative
ilegítimo	negative
ileso	positive
ilícito	negative
ilogicamente	negative
ilógico	negative
iluminar	positive
ilu	positive
ilusionadamente	positive
ilusionado	positive
ilusionar	positive
ilusion	positive
ilusión	positive
ilustrado	positive
ilustre	positive
imágenes#dantescas	negative
imaginable	positive
imaginación	positive
imaginarse	positive
imaginativamente	positive
imaginativo	positive
imbatido	positive
imbebible	negative
imbecil	negative
imbécil	negative
imitación	negative
immaculado	positive
imnovación	positive
impaciencia	negative
impacientar	negative
impacientemente	negative
impaciente	negative
impactante	positive
impactar	positive
imparcialmente	positive
imparcial	positive
impasible	negative
impecablemente	positive
impecable	positive
impedimento	negative
impedir	negative
impensable	negative
imperdonablemente	negative
imperdonable	negative
imperfeccion	negative
imperfección	negative
imperfecto	negative
imperial	negative
impersonal	negative
impertinencia	negative
impertinente	negative
impetuosidad	positive
ímpetu	positive
implacable	negative
implicación	negative
implicar	negative
implorar	negative
imponente	negative
imponer	negative
impopular	negative
importancia	positive
importantemente	positive
importante	positive
importar#tres#cojones	negative
importar#un#pimiento	negative
importunar	negative
importuno	negative
imposibilidad	negative
imposible	negative
imposición	negative
impostor	negative
impotencia	negative
impotentemente	negative
impotente	negative
imprecisamente	negative
imprecisión	negative
impreciso	negative
imprescindible	positive
Imprescindible	positive
impresentable	negative
Impresentable	negative
Impresentables	negative
impresionado	positive
impresionantemente	positive
impresionante	positive
impresionar	positive
imprevisto	negative
improbablemente	negative
improbable	negative
improductivo	negative
improperio	negative
impropiamente	negative
impropio	negative
Impropio	negative
improvisado	negative
imprudencia	negative
imprudentemente	negative
imprudente	negative
impudico	negative
impúdico	negative
impuesto	negative
impulsar	positive
impulsivo	negative
impulso	positive
impunidad	negative
impureza	negative
impuro	negative
imputación	negative
imputar	negative
inacabado	negative
inaccesible	negative
inaceptablemente	negative
inaceptable	negative
inactivo	negative
inadaptado	negative
inadecuadamente	negative
inadecuado	negative
inadmisiblemente	negative
inadmisible	negative
inagotable#al#desaliento	negative
inagotable	positive
inaguantable	negative
inamovible	negative
inanición	negative
inaplazable	positive
inapropiado	negative
Inaudito	negative
inaugurar	positive
incalculable	positive
incapacidad	negative
incapazmente	negative
incapaz	negative
incasto	negative
incendiario	negative
incendiar	negative
incendiarse	negative
incendio	negative
incertidumbre	negative
incesantemente	negative
incesante	negative
incesto	negative
incidencia	negative
incierto	negative
incitar	positive
incivilizado	negative
inclemente	negative
inclinación	positive
inclusivo	positive
incoherencia	negative
incoherentemente	negative
incoherente	negative
incomestible	negative
incómodamente	negative
incomodar	negative
incomodidad	negative
incomodisima	negative
incomodísimas	negative
incomodisimo	negative
incomodísimo	negative
incomodo	negative
incómodo	negative
incomparable	positive
incompetencia	negative
incompetentemente	negative
incompetente	negative
incompleto	negative
incomprensible	negative
inconcebible	negative
inconexo	negative
inconforme	negative
inconformidad	negative
inconfundible	positive
incongruentemente	negative
incongruente	negative
inconsciente	negative
inconsolable	negative
inconstante	negative
incontestable	positive
incontroladamente	negative
incontrolado	negative
incontrol	negative
inconveniente	negative
incordiante	negative
incordiar	negative
incordio	negative
incorrectamente	negative
incorrecto	negative
incredulidad	negative
incrédulo	negative
increíblemente	negative
increíble	negative
increible	positive
incremento#negativo	negative
increpacion	negative
incriminatorio	negative
incuestionable	positive
inculto	negative
incumplimiento#flagrante	negative
incumplimiento	negative
incumplir	negative
incurable	negative
indebido	negative
indecentemente	negative
indecente	negative
indeciblemente	negative
indecible	negative
indecisamente	negative
indeciso	negative
indecorosamente	negative
indecoroso	negative
indefensamente	negative
indefenso	negative
indemne	positive
indemnización	positive
indemnizar	positive
independencia	positive
independiente	positive
indeseable	negative
indeseado	negative
indiferencia	negative
indiferente	negative
indigencia	negative
indigente	negative
indigestión	negative
indignación	negative
indignado	negative
indignantemente	negative
indignante	negative
indignar	negative
indignidad	negative
indigno	negative
indiscreción	negative
indiscretamente	negative
indiscreto	negative
indiscriminadamente	negative
indiscriminado	negative
indiscutiblemente	positive
indiscutible	positive
indispensable	positive
indisponer	negative
indispuesto	negative
indistinguible	negative
individualidad	positive
individualismo	positive
indoloro	positive
indomable	positive
indomado	negative
indómito	positive
indubitable	positive
indudable	positive
indulgencia	positive
indulgente	positive
indultar	positive
indulto	positive
ineficacia	negative
ineficazmente	negative
ineficaz	negative
ineficiente	negative
ineludible	negative
ineptamente	negative
ineptitud	negative
inepto	negative
inequívoco	positive
inesperadamente	negative
inesperado	negative
inestabilidad	negative
inestable	negative
inestimable	positive
inevitable	negative
inexactamente	negative
inexacto	negative
inexcusablemente	negative
inexcusable	negative
inexorablemente	negative
inexorable	negative
inexperiencia	negative
inexpertamente	negative
inexperto	negative
inexplicable	negative
inexpresable	negative
inexpugnable	positive
infalible	positive
infamar	negative
infame	negative
infamia	negative
infantil	negative
infantiloide	negative
infatigable	positive
infausto	negative
infección	negative
infeccioso	negative
infectar	negative
infecto	negative
infecundo	negative
infedelidad	negative
infelicidad	negative
infelizmente	negative
infeliz	negative
inferioridad	negative
inferior	negative
infernal	negative
infestación	negative
infestar	negative
infidelidad	negative
infielmente	negative
infiel	negative
infierno	negative
ínfimo	negative
inflamado	negative
inflar	negative
inflexiblemente	negative
inflexible	negative
infligir	negative
influyente	positive
informativo	positive
infortunado	negative
infortunio	negative
infracción	negative
infrahumano	negative
inframundo	negative
infravaloración	negative
infravalorado	negative
infringir	negative
infructuoso	negative
infumable	negative
infundado	negative
ingenio	positive
ingeniosamente	positive
ingeniosidad	positive
ingenioso	positive
ingente	negative
ingenuamente	negative
ingenuo	negative
ingratitud	negative
ingrato	negative
ingresar#cadáver	negative
ingresar	positive
ingreso	positive
inhabitado	negative
inhibido	negative
inhospitalario	negative
inhóspito	negative
inhumano	negative
inicuamente	negative
inicuo	negative
inigualable	positive
iniquidad	negative
injuriante	negative
injuriar	negative
injurioso	negative
injustamente	negative
injusticia	negative
injustificable	negative
injustificado	negative
injusto	negative
inmaculadamente	positive
inmaculado	positive
inmaduro	negative
inmejorablemente	positive
inmejorable	positive
Inmejorable	positive
inmensamente	positive
inmensidad	positive
inmenso	positive
inmodestia	negative
inmoralidad	negative
inmoralmente	negative
inmoral	negative
inmortalizar	positive
inmundo	negative
inmune	positive
innecesariamente	negative
innecesario	negative
innegablemente	positive
innegable	positive
innoble	negative
innovación	positive
innovador	positive
innovar	positive
inocente	positive
inocuo	positive
inofensivo	positive
inolvidable	positive
inopia	negative
inoportunamente	negative
inoportuno	negative
inoxidable	positive
in	positive
inquebrantable	positive
inquietamente	negative
inquietantemente	negative
inquietante	negative
inquietar	negative
inquietarse	negative
inquieto	negative
inquietud	negative
inquina	negative
inquisición	negative
inquisidor	negative
inri	negative
insalvable	negative
insania	negative
insano	negative
insatisfacción	negative
insatisfactorio	negative
insatisfecho	negative
insecto	negative
inseguridad	negative
inseguro	negative
insensatamente	negative
insensatez	negative
insensato	negative
insensiblemente	negative
insensible	negative
inservible	negative
insidia	negative
insignificancia	negative
insignificantemente	negative
insignificante	negative
insipida	negative
insipido	negative
insípido	negative
insipidos	negative
insolencia	negative
insolentemente	negative
insolente	negative
insolitamente	positive
insólito	positive
insolvente	negative
insomnio	negative
insondable	negative
insoportablemente	negative
insoportable	negative
insostenible	negative
inspirador	positive
inspirar	positive
instigador	negative
instigar	negative
instinto#asesino	negative
institución#benéfica	positive
instructivo	positive
instruido	positive
insubordinado	negative
insubordinar	negative
insuficiencia	negative
insuficientemente	negative
insuficiente	negative
insufrible	negative
insulso	negative
insultante	negative
Insultante	negative
insultar	negative
insulto	negative
insultos	negative
insuperable	positive
insurreccionar	negative
insurrección	negative
insustituible	positive
intachable	positive
intacto	positive
íntegramente	positive
integridad	positive
íntegro	positive
intelectualmente	positive
inteligencia	positive
inteligentemente	positive
inteligente	positive
inteligentísimo	positive
intemperie	negative
intensamente	positive
interesadamente	negative
interesado	positive
interesante	positive
interesantísimas	positive
interesantísimo	positive
interesar	positive
interés	positive
interferir#en	negative
interferir	negative
interminablemente	negative
interminable	negative
interpretar#mal	negative
interrumpir	negative
intimidación	negative
intimidar	negative
íntimo	positive
intocable	negative
intolerablemente	negative
intolerable	negative
Intolerable	negative
intolerancia	negative
intolerante	negative
intoxicante	positive
intoxicar	positive
intranquilidad	negative
intranquilizar	negative
intranquilo	negative
intransigencia	negative
intransigentemente	negative
intransigente	negative
intratable	negative
intrépidamente	positive
intrepido	positive
intrépido	positive
intriga	negative
intrinquilo	negative
intrusion	negative
intuitivo	positive
inundación	negative
inundar	negative
inutilizable	negative
inutilmente	negative
inutil	negative
inútil	negative
invadir	negative
invalido	negative
inválido	negative
invasion	negative
invasión	negative
invasor	negative
invencible	positive
invención	negative
inventiva	positive
inventivo	positive
inverosimilitud	negative
inverosímil	negative
invitar	positive
ir#a#cagar	negative
iracundia	negative
iracundo	negative
ir#a#escardar#cebollinos	negative
ir#a#freír#espárragos	negative
ir#a#la#mierda	negative
ir#al#carajo	negative
ir#al#cuerno	negative
ir#al#diablo	negative
ir#a#lo#suyo	negative
ir#a#mayores	negative
ir#a#menos	negative
ira	negative
ir#a#por#todas	positive
irascible	negative
ir#a#tomar#por#culo	negative
ir#a#tomar#por#saco	negative
ir#bien#a	positive
ir#de#guatemala#a#guatepeor	negative
ir#de#la#ceca#a#la#meca	negative
ir#de#mal#en#peor	negative
ir#el#santo#al#cielo	negative
ir#la#olla	negative
ir#más#despacio	negative
ironía	negative
ironicamente	negative
irónico	negative
ir#para#largo	negative
ir#por#la#acera#de#los#tontos	negative
ir#por#lana#y#salir#trasquilado	negative
ir#por#los#cerros#de#Úbeda	negative
irracionalidad	negative
irracionalmente	negative
irracional	negative
irrealista	negative
irreconocible	negative
irreflexión	negative
irreflexivamente	negative
irreflexivo	negative
irregularidad	negative
irregular	negative
irrelevante	negative
irremediable	negative
irremisiblemente	negative
irreparable	negative
irrepetible	positive
irresistiblemente	positive
irresistible	positive
irrespetuosamente	negative
irrespetuoso	negative
irresponsable	negative
irreverentemente	negative
irreverente	negative
irreversible	negative
irrisión	negative
irrisorio	negative
irritabilidad	negative
irritable	negative
irritacion	negative
irritación	negative
irritado	negative
irritantemente	negative
irritante	negative
irritar	negative
jacarero	positive
jactancia	negative
jactancioso	negative
jactarse	negative
jajajajaja	positive
jajajajaj	positive
jajajaja	positive
jajaja	positive
jajajá	positive
jaleo	negative
jamacuco	negative
ja	positive
jaqueca	negative
jaque	negative
jaqueton	negative
jarabe#de#palo	negative
jarana	positive
jeje	positive
jesús	negative
jeta	negative
jeto	negative
jilipollas	negative
jiñarla	negative
ji	positive
jirón	negative
jobar	negative
jocoso	positive
jocundo	positive
joder#la#marrana	negative
joder	negative
jodido	negative
jodio	negative
joe	negative
Joe	negative
jolín	negative
jo	negative
Jo	negative
jope	negative
Jope	negative
jops	negative
jorobado	negative
jorobar	negative
jovial	positive
joya#escondida	positive
joya	positive
jubilo	positive
júbilo	positive
jubilosamente	positive
jubiloso	positive
juerga	positive
jugar#con#fuego	negative
jugar#la#vida	negative
jugar#limpio	positive
jugar#sucio	negative
juiciosamente	positive
juicioso	positive
julandrón	negative
justamente	positive
justicia	positive
justiciero	positive
justificadamente	positive
justificado	positive
justo	positive
juzgar#mal	negative
laboriosamente	negative
laborioso	positive
la#caja#tonta	positive
lacerar	negative
laceria	negative
lacónico	negative
lacra	negative
lacrimoso	negative
ladilla	negative
ladino	negative
ladrar	negative
lagarto#lagarto	negative
lágrima	negative
lagrimar	negative
lágrimas	negative
lagrimear	negative
lagrimoso	negative
laido	negative
la#mar#de#bien	positive
la#mejor	positive
la#menos	negative
lamentablemente	negative
lamentable	negative
lamentar	negative
lamentarse	negative
lamento	negative
lamentoso	negative
lánguidamente	negative
languidecer	negative
lánguido	negative
lapsus	negative
larga	negative
largar	negative
largarse	negative
larva	negative
las#armas#las#carga#el#diablo	negative
lascivamente	negative
lascivo	negative
las#mejores	positive
las#menos	negative
lastima	negative
lástima	negative
lastimar	negative
lastimeramente	negative
lastimero	negative
lastimosamente	negative
lastimoso	negative
látigo	negative
latoso	negative
laudable	positive
lavar#las#manos	negative
lealmente	positive
leal	positive
lealtad	positive
ledamente	positive
leer#mal	negative
legalmente	positive
legal	positive
legendario	positive
legitimamente	positive
legítimo	positive
leñe	negative
lengüicorto	negative
lenificar	positive
lenizar	positive
lentamente	negative
lentisimo	negative
lentísimo	negative
lento	negative
Lentos	negative
lepra	negative
lesionado	negative
lesion	negative
letalmente	negative
letal	negative
levantar#con#el#pie#izquierdo	negative
levantar#la#voz	negative
levantar	positive
liante	negative
liar	negative
liberación	positive
liberalmente	positive
liberal	positive
liberar	positive
libertad	positive
libertar	positive
libertinaje	negative
libidinoso	negative
libremente	positive
libre	positive
libro#de#reclamaciones	negative
licenciosamente	negative
licencioso	negative
lícito	positive
liderazgo	positive
líder	positive
lidiar	negative
ligero	positive
limpiar#a#fondo	positive
limpiar	positive
limpieza	positive
limpio	positive
limpisimo	positive
limpísimo	positive
linchado	negative
lindo	positive
lio	negative
lío	negative
liquidar#a	negative
lisiado	negative
lisonjero	positive
liso	positive
listo	positive
listos	positive
llaga	negative
llamativo	negative
llanto	negative
llegar#y#besar#el#santo	positive
llenar	positive
lleno#de#acontecimientos	positive
lleno#de#baches	negative
lleno#de#polvo	negative
lleno	positive
llevar#claro	negative
llevar#de#calle	positive
llevar#las#de#perder	negative
llevar#mal	negative
llevar#por#la#calle#de#la#amargura	negative
llevar#una#vida#de#perros	negative
llevar#un#chasco	negative
llorar#a#lágrima#viva	negative
llorar#a#mares	negative
llorar	negative
llorera	negative
llorica	negative
lloriquear	negative
lloro	negative
llorón	negative
lloroso	negative
llover#a#cántaros	negative
llover#a#mares	negative
llover#hostias	negative
llover#sobre#mojado	negative
loable	positive
lobotomizados	negative
lóbregamente	negative
lobrego	negative
lóbrego	negative
locatis	negative
loco	negative
locura	negative
lodo	negative
lógicamente	positive
lógica	positive
lógico	positive
logrado	positive
lograr	positive
logro	positive
lo#malo	negative
lo#mejor#de#cada#casa	negative
lo#mejor	positive
lo#menos	negative
lo#mínimo	negative
longanimidad	positive
lo#nutritivo	positive
looser	negative
lo#peor#de#todo	negative
lo#peor	negative
los#árboles#no#te#dejan#ver#el#bosque	negative
los#mejores	positive
los#menos	negative
lo#único#positivo	negative
love	positive
lozania	negative
lrascible	negative
luchador	positive
lucha	negative
luchar	negative
lúcido	positive
lucimiento	positive
lucrativo	positive
lucro	positive
luctuosamente	negative
luctuoso	negative
lugar#con#encanto	positive
lugubre	negative
lúgubre	negative
lugubres	negative
lujazo	positive
lujo	positive
lujosamente	positive
lujoso	positive
lujurioso	negative
luminosidad	positive
luminoso	positive
luna#de#miel	positive
lustre	positive
lustroso	positive
luto	negative
lutoso	negative
luxurioso	negative
luz#deslumbrante	negative
macabro	negative
maca	negative
macanudo	positive
macarra	negative
machacao	negative
machacona	negative
machacón	negative
machismo	negative
machista	negative
machorra	negative
maco	negative
madurado	positive
madurar	positive
madurez	positive
maduro	positive
maestria	positive
maestría	positive
maestro	positive
mafia	negative
mafioso	negative
magia	positive
mágicamente	positive
mágico	positive
magistralmente	positive
magistral	positive
magnanimamente	positive
magnanime	positive
magnetismo	positive
magnetizar	positive
magnificamente	positive
magníficamente	positive
magnificencia	positive
magnifico	positive
magnífico	positive
Magnífico	positive
magnifíco	positive
magnificos	positive
magno	positive
mago	positive
magulladura	negative
magullar	negative
magullarse	negative
majadero	negative
majara	negative
majareta	negative
majestuosidad	positive
majestuoso	positive
majo	positive
mala#fortuna	negative
mala#hierba	negative
mala#leche	negative
malamente	negative
malandante	negative
Mala	negative
mala#pata	negative
mala#pronunciación	negative
mala#reputación	negative
malasangre	negative
malas#caras	negative
malaventurado	negative
mala#yerba#nunca#muere	negative
malcontento	negative
malcriado	negative
maldad	negative
maldecir	negative
maldicion	negative
maldición	negative
maldito	negative
maldito#sea	negative
maleducadamente	negative
maleducado	negative
malentendido	negative
malestar	negative
malevolamente	negative
malévolo	negative
malgastar	negative
mal#genio	negative
malhablado	negative
malhadado	negative
malhayas	negative
malhechor	negative
malhumoradamente	negative
malhumorado	negative
malhumorar	negative
malhumor	negative
malicia	negative
maliciar	negative
malicioso	negative
malignidad	negative
maligno	negative
malintencionado	negative
malisimamente	negative
malisima	negative
Malisima	negative
malisimas	negative
malisimo	negative
Malisimo	negative
malísimo	negative
Malísimo	negative
malisimos	negative
mal	negative
malogro	negative
maloliente	negative
malo	negative
malos#tratos	negative
mal#pagado	negative
malpensado	negative
malquerencia	negative
malsano	negative
mal#situado	negative
maltratar	negative
maltrato	negative
maltrecho	negative
malucho	negative
mal#uso	negative
malvadamente	negative
malvado	negative
mal#vestido	negative
mamá	positive
mamola	negative
mamón	negative
manazas	negative
mancha	negative
manchar	negative
mancharse	negative
manda#huevos	negative
mandar#a#cagar	negative
mandar#a#escardar#cebollinos	negative
mandar#a#freír#espárragos	negative
mandar#a#la#mierda	negative
mandar#al#carajo	negative
mandar#al#cuerno	negative
mandar#al#diablo	negative
mandar#a#paseo	negative
mandar#a#tomar#por#culo	negative
mandar#a#tomar#por#saco	negative
manejo	negative
mangante	negative
mangar	negative
mangui	negative
maníaco	negative
mania	negative
manía	negative
manido	negative
manipulación	negative
manipulador	negative
manipular	negative
manjar	positive
mantener#el#tipo	positive
mantener	positive
maquiavélicamente	negative
marana	negative
maraña	negative
maravillado	positive
maravilla	positive
maravillar	positive
maravillarse	positive
maravillosamente	positive
Maravillosa	positive
maravilloso	positive
marchitar	negative
marchitarse	negative
marco#incomparable	positive
mareado	negative
mareante	negative
marear#la#perdiz	negative
marginado	negative
marginalmente	negative
maricón	negative
marrano	negative
marrón	negative
martirio	negative
martirizar	negative
maruja	negative
masacrar	negative
masacre	negative
mascar#la#tensión	negative
mascar#la#tragedia	negative
masoquista	negative
mas	positive
máster	positive
matamoros	negative
matanza	negative
matao	negative
matar#de#hambre	negative
matar#dos#pájaros#de#un#tiro	positive
matar#moscas#a#cañonazos	negative
matar	negative
maton	negative
matón	negative
matraca	negative
maximo	positive
mayor	positive
mazmorra	negative
mear#fuera#del#tiesto	negative
¡mecachis!	negative
mecachis	negative
mecer	positive
medalla	positive
mediatizado	negative
mediocre	negative
mediocridad	negative
medrana	negative
medrar	positive
medroso	negative
mefítico	negative
me#huele#a#chamusquina	negative
mejorado	positive
mejora	positive
mejorar	positive
mejorar#respecto#a	positive
mejorarse	positive
mejorcito	positive
mejor	positive
melancolia	negative
melancolía	negative
melancólicamente	negative
melancolico	negative
melancólico	negative
melodrama	negative
melodramático	negative
melon	negative
meloso	positive
memez	negative
memorable	positive
mendigar	negative
mendigo	negative
mendrugo	negative
menesteroso	negative
menguante	negative
menguar	negative
menos#lobos#caperucita#menos#lobos	negative
menospreciar	negative
menosprecio	negative
menso	negative
mentar#la#soga#en#casa#del#ahorcado	negative
mentira	negative
Mentira	negative
mentiras	negative
mentir	negative
mentiroso	negative
merda	negative
merecedor	positive
merecer#la#pena	positive
merecer	positive
merecidamente	positive
merecidas#vacaciones	positive
merecido	positive
merito	positive
mérito	positive
meritorio	positive
mermar	negative
mero	negative
metedura#de#pata	negative
meteórico#ascenso	positive
meter#baza	negative
meter#donde#no#le#llaman	negative
meter#en#camisa#de#once#varas	negative
meter#en#cintura	negative
meter#en#lo#que#no#le#importa	negative
meter#en#vereda	negative
meter#la#pata	negative
métete#en#tus#asuntos	negative
meticulosamente	positive
meticuloso	positive
metódico	positive
mezquinamente	negative
mezquindad	negative
mezquino	negative
miéchica	negative
mieditis	negative
miedo	negative
miedoso	negative
mientras#hay#vida#hay#esperanza	positive
mierda	negative
milagro	positive
milagrosamente	positive
milagroso	positive
milimétricamente	positive
millonario	positive
milonga	negative
mimado	negative
mimar	positive
mimo	positive
minar	negative
minuciosamente	positive
minúsculo	negative
minusválido	negative
mirada#feroz	negative
mirada#lasciva	negative
miramiento	positive
mirar#con#buenos#ojos	positive
mirar#con#ceño	negative
mirar#con#recelo	negative
mirar#el#ombligo	negative
mirar#ferozmente	negative
mirar	positive
miscelaneo	negative
miserablemente	negative
miserable	negative
míseramente	negative
miseria	negative
misericordia	positive
misericordiosamente	positive
misericordioso	positive
misero	negative
mísero	negative
misérrimamente	negative
misoneísmo	negative
miss	positive
misterioso	negative
mítico	positive
mitigar	positive
mixto	negative
moco	negative
mocoso	negative
modales#exquisitos	positive
modales#refinados	positive
modélico	positive
moderno	positive
modestia	positive
modesto	positive
módico	positive
mofa	negative
mofarse#de	negative
mofarse	negative
mohíno	negative
mohoso	negative
mojón	positive
mola	positive
molar#mazo	positive
molar#un#huevo	positive
molestamente	negative
molestar	negative
molestarse	negative
molestia	negative
molesto	negative
molestoso	negative
mollar	positive
moña	negative
mono	positive
monotonía	negative
monotono	negative
monótono	negative
monstruo	negative
monstruosamente	negative
monstruosidad	negative
monstruoso	negative
montar#en#cólera	negative
montar#un#cirio	negative
montar#un#pollo	negative
monumental	positive
morado	negative
moral	positive
morbido	negative
mórbido	negative
morbosamente	negative
morbosidad	negative
morbositat	negative
morboso	negative
mordacidad	positive
mordaz	negative
morder#el#anzuelo	negative
morder#la#lengua	negative
morder	negative
morir#de#ganas#de#hacer	positive
morir	negative
morriña	negative
morro	negative
mortalmente	negative
mortal	negative
mortandad	negative
mortifero	negative
mortífero	negative
mortificacion	negative
mortificar	negative
mortuorio	negative
mosca	negative
mosconear	negative
mosquearse	negative
mosqueo	negative
mostrar#consternado	negative
motivación	positive
motivar	positive
mounstro	negative
mover	positive
movida	negative
muchisimas	positive
muchísimas	positive
mucho	positive
mudo	negative
mueca#de#desprecio	negative
mueca#de#dolor	negative
mueca	negative
muermo	negative
muerte	negative
muerto#de#hambre	negative
muerto	negative
mugre	negative
mugriento	negative
multa	negative
multar	negative
multimillonario	positive
multiplicarse#por#cero	negative
mundano	negative
murio	negative
muscular	positive
musicalmente	positive
musical	positive
mustiamente	negative
mustio	negative
mutilar	negative
muy#aficionado	positive
muy#bien	positive
muy#grave	negative
muy#peligroso	negative
nada#de#el#otro#mundo	negative
nada#de#nada	negative
nada#recomendable	negative
nadar#y#guardar#la#ropa	positive
ñam	positive
nanay	negative
narices	negative
nato	positive
naturalidad	positive
naturalmente	positive
naufragar	negative
naufragio	negative
nauseabundamente	negative
nauseabundo	negative
náusea	negative
nausear	negative
náuseas	negative
nauseoso	negative
navajazo	negative
nazi	negative
neblina	negative
necesidad	negative
necesitado	negative
necesitar	negative
neciamente	negative
necio	negative
nefasto	negative
Nefasto	negative
negación	negative
negar#el#pan#y#la#sal	negative
negar	negative
negarse	negative
negativa	negative
negativo	negative
negligencia	negative
negligente	negative
negociar	positive
negro	negative
nerdo	negative
nervio	negative
nerviosamente	negative
nerviosidad	negative
nerviosismo	negative
nervioso	negative
neurótico	negative
ni#chicha#ni#limoná	negative
ni#de#coña	negative
niebla	negative
ni#fu#ni#fa	negative
nigga	negative
ni#hablar#del#peluquín	negative
nítido	positive
nivelar	positive
nivelarse	positive
noble	positive
nobleza	positive
no#caber#el#corazón#en#el#pecho	positive
no#caer#los#anillos#por#hacer	negative
no#cagues#donde#comes	negative
no#callar#ni#bajo#el#agua	negative
nocivamente	negative
nocivo	negative
no#comerse#una#rosca	negative
no#cortar#ni#un#pelo	negative
no#creer	negative
nocturno	negative
no#cualificado	negative
no#dar#ni#una	negative
no#dar#palo#al#agua	negative
no#dar#pie#con#bola	negative
no#dar#un#palo#al#agua	negative
no#decir#ni#mu	negative
no#deseado	negative
no#disponible	negative
no#entender	negative
no#eres#más#tonto#porque#no#te#entrenas	negative
no#estar#a#lo#que#se#está	negative
no#estar#el#horno#para#bollos	negative
no#estar#en#tus#cabales	negative
no#gana#para#sustos	negative
no#gustarle#a#uno	negative
no#hacer#caso#de	negative
no#hay#peor#enemigo#que#un#mal#amigo	negative
no#le#busques#tres#pies#al#gato	negative
no#lucir#el#pelo	negative
nombroso	positive
no#mover#ni#un#dedo	negative
no#necesitar#abuela	negative
no	negative
ñoño	negative
no#poder#estar	negative
no#ralles	negative
no#reconocer	negative
no#resuelto	negative
no#saber#hacer#la#o#con#un#canuto	negative
no#saber#ni#papa	negative
no#seas#tan#fantasma	negative
no#se#fía#ni#de#su#padre	negative
no#ser#como#para#tirar#cohetes	negative
no#ser#de#recibo	negative
no#ser#para#tanto	negative
nos#están#meando#y#dicen#que#llueve	negative
nostalgia	negative
nostálgico	negative
notablemente	positive
notable	positive
no#te#lo#crees#ni#tú	negative
no#tener#arte#ni#parte	negative
no#tener#dónde#caer#muerto	negative
no#tener#ni#para#pipas	negative
no#tener#ni#pies#ni#cabeza	negative
no#tener#ni#un#duro	negative
no#tener#remedio	negative
no#te#rayes	negative
notoriamente	positive
notorio	positive
novedoso	positive
no#ver#tres#en#un#burro	negative
nublar	negative
nuestro	positive
nuevecito	positive
nuevo	positive
nula#profesionalidad	negative
nulo	negative
nutritivo	positive
oasis	positive
obediencia	positive
obedientemente	positive
obediente	positive
obeso	negative
objetivamente	positive
objetos#de#valor	positive
obligación	negative
obligada#visita	positive
obligar	negative
obligatorio	negative
obra#maestra	positive
obra	positive
obscenamente	negative
obscenidades	negative
obscenidad	negative
obsceno	negative
obscuridad	negative
obscuro	negative
obsequiar	positive
obsesionante	negative
obsesionar	negative
obsesión	negative
obsesivamente	negative
obsesivo	negative
obsoleto	negative
obstaculizar	negative
obstaculo	negative
obstáculo	negative
obstinacion	negative
obstinado	negative
obstrucción	negative
obstruir	negative
obstruirse	negative
obtener#el#título	positive
obtener	positive
obtuso	negative
obviedad	negative
obvio	positive
ocasion	positive
ocultar	negative
oculto	negative
ocupar	negative
ocuparse#de	positive
odiado	negative
odiar	negative
odio	negative
odiosamente	negative
odioso	negative
oeoeoeoeoeoeoe	positive
ofender	negative
ofensa	negative
ofensivamente	negative
ofensividad	negative
ofensivo	negative
oferta	positive
ofrecerse	negative
ofrecer#su#amistad#a	positive
ofuscamiento	negative
ojeriza	negative
ojeroso	negative
ojete	negative
o#jodemos#todos#o#matamos#la#puta	negative
o#jugamos#todos#o#rompemos#la#baraja	negative
okay	positive
ok	positive
ole	positive
olé	positive
olor#a#tabaco	negative
olvidar	negative
olvidarse#de	negative
olvidarse	negative
olvido	negative
ominar	negative
omisión	negative
omiso	negative
omitir	negative
onda#expansiva	negative
ondear	positive
onerosamente	negative
onírico	positive
opacidad	negative
opimo	positive
opíparo	positive
oponer	negative
oponerse#a	negative
oponerse	negative
oportunamente	positive
oportuno	positive
oposicion	negative
oposición	negative
opresion	negative
opresión	negative
opresivamente	negative
opresivo	negative
opresor	negative
oprimente	negative
oprimir	negative
oprobio	negative
optimismo	positive
optimista	positive
optimo	positive
óptimo	positive
opulencia	positive
opulento	positive
ordenadamente	positive
ordenado	positive
ordenar	positive
ordinariez	negative
ordinario	negative
orgásmico	positive
orgullo	positive
orgullosamente	positive
orgulloso	negative
orgullo#y#satisfacción	positive
originalidad	positive
originalmente	positive
original	positive
orina	negative
oro	positive
osadamente	positive
osadía	positive
osado	positive
osar	positive
oscuramente	negative
oscurecer	negative
oscuridad	negative
oscuro	negative
ostentar	negative
ostentoso	negative
ostia#puta	negative
otorgar	positive
ovacionar	positive
ovacion	positive
ovación	positive
pachucho	negative
paciencia	positive
pacientemente	positive
paciente	positive
pacíficamente	positive
pacificar	positive
pacifico	positive
pacífico	positive
pacifista	positive
pactar	positive
pacto	positive
padecer	negative
padecimiento	negative
pagar#los#platos#rotos	negative
pagar	negative
pajolero	negative
palabrota	negative
paladar#exquisito	positive
paladear	positive
palangana	negative
paleto	negative
palidecer	negative
palido	negative
pálido	negative
paliza	negative
palizas	negative
palmarla	negative
palmas	positive
palurda	negative
palurdo	negative
pánico	negative
panoli	negative
panorámico	positive
panteón	negative
papanatas	negative
papelón	negative
para#colmo	negative
parada#obligatoria	positive
paradójicamente	negative
paradójico	negative
parado	negative
paraiso	positive
paraíso	positive
paralización	negative
paralizar	negative
paranoia	negative
paranoico	negative
para#olvidar	negative
parasito	negative
parásito	negative
parcialidad	negative
parcial	negative
paria	negative
parida	negative
parlotear	negative
parloteo	negative
parodia	negative
parodiar	negative
paro	negative
parranda	positive
parte#floja	negative
partidario	positive
partidazo	positive
partidista	negative
partir	negative
pasada	negative
pasado	negative
pasar#a#una#el#arroz	negative
pasar#bien	positive
pasar#canutas	negative
pasar#de	negative
pasar#de#todo	negative
pasar#factura	negative
pasar#hambre	negative
pasar#la#factura	negative
pasar#las#de#caín	negative
pasar#lor#alto	negative
pasar#mal	negative
pasar#putas	negative
pasar#tres#pueblos	negative
pasatiempo	positive
pasional	positive
pasion	positive
pasión	positive
pasivo	negative
pasmado	negative
pasmoso	negative
pasota	negative
pasotismo	negative
pasteloso	negative
patada	negative
patan	negative
patatero	negative
patera	negative
patéticamente	negative
patético	negative
patinazo	negative
patológico	negative
patoso	negative
patriota	positive
paupérrimamente	negative
paupérrimo	negative
pávido	negative
pavor	negative
pavorosamente	negative
pavoroso	negative
paz	positive
pebete	negative
pecado	negative
pecadoramente	negative
pecador	negative
pecaminosamente	negative
pecaminoso	negative
pecar	negative
pedante	negative
pedazo	positive
pederasta	negative
pedir#a#gritos	negative
pedir	negative
pedir#peras#al#olmo	negative
pedófilo	negative
pedo	negative
pegadizo	positive
pegajoso	negative
pega	negative
pegar	negative
pegar#una#leche	negative
pegar#un#palo	negative
pejiguero	negative
pelársela	negative
pelea	negative
pelear	negative
pelearse	negative
peligrar	negative
peligro	negative
peligrosamente	negative
peligroso	negative
pelillos#a#la#mar	positive
pellizcar	negative
pellizco	negative
pelma	negative
pelmazo	negative
peloteo	negative
pelotudo	negative
penacho	negative
penalidad	negative
penalizar	negative
pena	negative
penar	negative
peñazo	positive
pencar	negative
pendejo	negative
pendenciar	negative
pendenciero	negative
penetrante	positive
penitencia	negative
penitente	positive
penosamente	negative
penoso	negative
penumbra	negative
peor#enemigo	negative
peor	negative
pequeño#lujo	positive
pequeno	negative
peque	positive
percance	negative
perdedor	negative
perder#aceite	negative
perder#comba	negative
perder#el#tiempo	negative
perder#la#cabeza	negative
perder#la#chaveta	negative
perder#la#esperanza	negative
perder#la#vida	negative
perder	negative
perderse	negative
perdicion	negative
perdición	negative
pérdida	negative
perdido	negative
perdido#sin#remedio	negative
perdio	negative
perdonar	positive
perdonavidas	negative
perdon	positive
perdurar	positive
perecer	negative
pereza	negative
perezoso	negative
perfeccionamiento	positive
perfeccionar	positive
perfeccion	positive
perfección	positive
perfectamente	positive
perfecto	positive
perfido	negative
pérfido	negative
perfume#embriagador	positive
pericia	positive
perinquina	negative
perito	positive
perjudicar	negative
perjudicialmente	negative
perjudicial	negative
perjuicio	negative
perla	positive
permiso	positive
permitir	positive
pernicioso	negative
pero	negative
perplejidad	negative
perplejo	negative
perra	negative
persecución	negative
perseguir	negative
perseverante	positive
persistente	positive
perspicacia	positive
perspicazmente	positive
perspicaz	positive
persuasivamente	positive
pertinazmente	negative
pertinaz	negative
pertinaz#sequía	negative
pertinente	positive
perturbación	negative
perturbado	negative
perturbador	negative
perturbar	negative
perversamente	negative
perversidad	negative
perversiones	negative
perversión	negative
perverso	negative
pervertido	negative
pervertir	negative
pesadamente	negative
pesadez	negative
pesadilla	negative
Pesadilla	negative
pesado	negative
pesadumbre	negative
pésame	negative
pesar	negative
pesaroso	negative
pescuezo	negative
pésimamente	negative
pesima	negative
Pesima	negative
Pésima	negative
pesimismo	negative
pesimista	negative
Pesimo	negative
PESIMO	negative
pésimo	negative
Pésimo	negative
Pésimo#Servicio	negative
peso	negative
pestazo	negative
peste	negative
pestilente	negative
petardear	negative
petrificar	negative
petrificarse	negative
peyorativo	negative
pfff	negative
Pfff	negative
piadoso	positive
picado	negative
picadura	negative
picar	negative
picaro	negative
pícaro	negative
picarse	negative
picota	negative
piedad	positive
pies#en#polvorosa	negative
pifiarla	negative
pifiar	negative
pillaje	negative
pillo	negative
pinchar	negative
pinche	negative
pinga	negative
pintar#menos#que#la#tomasa#en#los#títeres	negative
pintoresco	positive
piojoso	negative
pipí	negative
pique	negative
piquete	negative
pirateo	negative
piratería	negative
pirotécnico	positive
pisar#los#talones	negative
pisotear	negative
pizca	negative
placentero	positive
placer	positive
placidez	positive
placido	positive
plaga	negative
plagar	negative
plagiar	negative
plantar#cara	positive
plantista	negative
platónicamente	positive
playitaa	positive
pleitesía	positive
pleito	negative
plenamente	positive
plenitud	positive
pleno#centro	positive
pleno	positive
poblacho	negative
pobrecito	negative
pobremente	negative
pobre	negative
pobrete	negative
pobreteria	negative
pobreto	negative
pobreza	negative
pocilga	negative
poco#amable	negative
poco#amistoso	negative
poco#apropiado	negative
poco#claro	negative
poco#delicado	negative
poco#dispuesto	negative
poco#fiable	negative
poco#fidedigno	negative
poco#honrado	negative
poco#natural	negative
poco	negative
poco#práctico	negative
poco#profundo	negative
poco#prometedor	negative
poco#razonable	negative
poco#rentable	negative
poderosamente	positive
poderoso	positive
poder	positive
podrido	negative
podrir	negative
poetico	positive
poético	positive
polémica	negative
polémico	negative
polifacético	positive
polución	negative
polvoriento	negative
pompa	positive
pomposo	negative
poner#a#caer#de#un#burro	negative
poner#a#caldo	negative
poner#a#cien	positive
poner#a#parir	negative
poner#borde	negative
poner#cara#de#ajo#pocho	negative
poner#cara#de#circunstancias	negative
poner#cara#de#pocos#amigos	negative
poner#ciego	positive
poner#de#los#nervios	negative
poner#de#relieve	positive
poner#de#vuelta#y#media	negative
poner#en#claro	positive
poner#en#el#disparadero	negative
poner#en#entredicho	negative
poner#enfermo	negative
poner#en#la#calle	negative
poner#en#libertad	positive
poner#en#lo#peor	negative
poner#en#paz#con#dios	positive
poner#en#peligro	negative
poner#en#ridículo	negative
poner#en#un#brete	negative
poner#en#valor	positive
poner#hecho#una#fiera	negative
poner#las#cosas#en#su#sitio	positive
poner#los#puntos#sobre#las#íes	positive
poner#mala#cara	negative
poner#manos#a#la#obra	positive
poner#nervioso	negative
poner#obstáculos#a	negative
poner#pegas	negative
poner#pesado	negative
poner#plasta	negative
ponerse#de#acuerdo	positive
poner#una#emboscada#a	negative
poner#una#multa	negative
poner#una#pica#en#flandes	positive
poner#una#vela#a#dios#y#otra#al#diablo	negative
poner#verde	negative
popo	negative
popularidad	positive
populista	negative
por#arte#de#birlibirloque	positive
porfiado	positive
porfin	positive
pornografia	negative
pornografía	negative
pornográfico	negative
porqueria	negative
porquería	negative
por#supuesto	positive
portazo	negative
poseído	negative
posesivo	negative
positivamente	positive
positivo	positive
postizo	negative
postre	positive
potar	negative
potencial	positive
potenciar	positive
potentemente	positive
potente	positive
potentísimo	positive
potra	positive
practicable	positive
práctico	positive
pragmático	positive
precariamente	negative
precariedad	negative
precario	negative
precaucion	positive
precaución	positive
preciado	positive
precio#abusivo	negative
precio#asequible	positive
precio#desorbitado	negative
preciosamente	positive
preciosa	positive
Preciosas	positive
preciosidad	positive
precioso	positive
precipicio	negative
precipitación	negative
precipitadamentemente	negative
precipitadamente	negative
precipitado	negative
precipitar	negative
precisamente	positive
precisión	positive
preciso	positive
precozmente	positive
precoz	positive
predecible	negative
predilecto	positive
predominante	positive
preferencia	positive
preguntarse	positive
prejuicio	negative
prejuzgar	negative
prematuro	negative
premiar	positive
premio	positive
premonición	negative
prender	negative
preocupacion	negative
preocupación	negative
preocupadamente	negative
preocupado	negative
preocupante	negative
preocupar	negative
preocuparse	negative
preparado	positive
prepotencia	negative
prepotente	negative
prerrogativa	positive
prescindible	negative
preservacion	positive
preservar	positive
presionar	negative
presión	negative
preso	negative
prestigio	positive
prestigioso	positive
presto	positive
presumido	negative
presumir	positive
presuntuosamente	negative
presuntuoso	negative
pretenciosamente	negative
pretencioso	negative
pretender	negative
pretension	negative
prevaricación	negative
prevaricador	negative
prevencion	positive
prevención	positive
prever	positive
previsible	negative
prevision	positive
prima	positive
primera#categoría	positive
primitivo	negative
primordial	positive
primorosamente	positive
pringada	negative
pringado	negative
pringao	negative
pringar	negative
prioridad	positive
prisa	negative
prisionero	negative
prisión	negative
prístino	positive
privacion	negative
privación	negative
privar	negative
privilegio	positive
probar	negative
problema	negative
problemas	negative
Problemas	negative
procaz	negative
prodigio	positive
prodigiosamente	positive
prodigioso	positive
pródigo	negative
prodigo	positive
productivo	positive
proeza	positive
proezas	positive
profanar	negative
profesionalidad	positive
profesionalmente	positive
profesional	positive
profundamente	positive
profundidad	positive
profundo	negative
profusion	positive
profusión	positive
progresar	positive
progresividad	positive
progresivo	positive
progreso	positive
prohibir	negative
prohibitivo	negative
prolifero	positive
prolífico	positive
promesa	positive
prometedoramente	positive
prometedor	positive
prometer	positive
prominencia	positive
prominente	positive
promiscuo	negative
promoción	positive
pronto	positive
pronunciar#mal	negative
propaganda	negative
propiamente	positive
propiciamente	positive
propiciar	positive
propicio	positive
proponer	positive
proporcionar	positive
propugnar	positive
proscrito	negative
prosperamente	positive
prosperar	positive
prosperidad	positive
próspero	positive
prostitución	negative
prostituido	negative
prostituta	negative
protagonizar	positive
protección	positive
protectoramente	positive
protector	positive
proteger	positive
protervo	negative
protesta	negative
protestar	negative
provecho	positive
provechosamente	positive
provechoso	positive
providencial	positive
providencia	positive
provocación	negative
provocado	negative
provocador	negative
provocar	negative
provocativo	negative
proximidad	positive
prudencia	positive
prudentemente	positive
prudente	positive
psicópata	negative
psicótico	negative
puaf	negative
publicidad#engañosa	negative
pucha	negative
puchero	negative
pudiente	positive
pudrir	negative
pudrirse	negative
puercamente	negative
puerco	negative
pueril	negative
puff	negative
puf	negative
pugna	negative
pugnante	negative
pujanza	positive
pulcramente	positive
pulcro	positive
pulir	positive
pulla	negative
puñalada	negative
puñeta	negative
puñetas	negative
puñetazo	negative
puñetero	negative
punico	negative
puntapié	negative
puntilloso	negative
puntual	positive
punzada	negative
punzar	negative
puro	positive
purpura	positive
pusilánime	negative
pusilanimidad	negative
pus	negative
puta	negative
putear	negative
puteria	negative
puto	negative
putrefacción	negative
putrido	negative
qué#alegría#qué#alboroto:#otro#perrito#piloto	positive
quebradero	negative
quebradizo	negative
quebrado	negative
quebrantar	negative
quebrantarse	negative
quebranto	negative
quebrar	negative
que#cada#palo#aguante#su#vela	negative
quedar#a#dos#velas	negative
quedar#en#agua#de#borrajas	negative
quedar#en#blanco	negative
quedar#sopa	negative
quedar#tal#cual	negative
quedar#tres#neuronas	negative
quedar#tres#telediarios	negative
que#dios#reparta#suerte	positive
queja	negative
quejar	negative
quejarse	negative
quejica	negative
quejido	negative
quemado	negative
quemadura	negative
quemarse	negative
que#no#tiene#precio	positive
querella	negative
querellar	negative
querer#es#poder	positive
querer	positive
querido	positive
queridos#amigos	positive
querubico	positive
que#te#folle#un#pez	negative
que#tiene#éxito	positive
que#tiene#un#valor#de	positive
que#vale#la#pena	positive
que#vale	positive
quia	negative
quicio	negative
quiebra	negative
quien#parte#y#reparte#se#queda#la#mejor#parte	positive
quien#se#pica#ajos#come	negative
quien#siembra#vientos#recoge#tempestades	negative
quién#te#ha#visto#y#quién#te#ve	negative
quien#tuvo#retuvo	positive
quierooooo	positive
quiero	positive
quietud	positive
quillotrar	positive
quimerico	positive
quinqui	negative
quisquillosamente	negative
quisquillosismo	negative
quisquilloso	negative
quitar#importancia#a	negative
quitar#mérito	negative
quitar	negative
quitarse#de#encima	negative
quite#que#la#carne#de#burro#no#es#transparente	negative
rabia	negative
rabiar	negative
rabieta	negative
rabiosamente	negative
rabioso	negative
rácano	negative
racional	positive
racismo	negative
racista	negative
radiantemente	positive
radiante	positive
radical	negative
rajar	negative
rajarse	negative
rajon	negative
rallar	negative
ramera	negative
rancio	negative
rapidamente	positive
rápidamente	positive
rapidez	positive
rápido	positive
raquítico	negative
raramente	negative
rarito	negative
raro	negative
rascar#la#barriga	negative
rasgar#las#vestiduras	negative
rasguno	negative
raspadura	negative
rastrero	negative
rata	negative
ratificar	positive
raudo	positive
rayar	negative
razonablemente	positive
razonable	positive
razonar	positive
razón	positive
reaccionario	negative
reaciamente	negative
reacio	negative
realizable	positive
realización	positive
realizar	positive
realmente	positive
real	positive
realzar	positive
reanimar	positive
reaparición	positive
rebajado	positive
rebajar	negative
rebelde	negative
rebelión	negative
rebosante	negative
rebuscado	negative
recaer	negative
recaída	negative
recalcitrante	negative
recargable	positive
recargado	negative
recargo	negative
recaudo	positive
recelar	negative
recelo	negative
recelosamente	negative
receloso	negative
recesion	negative
recesión	negative
rechazamiento	negative
rechazar	negative
rechazo	negative
recibir	positive
recién	positive
reclamacion	negative
reclamación	negative
reclamar	negative
recochineo	negative
recoger	positive
recogimiento	positive
recomendable	positive
recomendación	positive
recomendado	positive
Recomendado	positive
recomendar	positive
recompensa	positive
recompensar	positive
reconciliación	positive
reconciliar	positive
reconfortante	positive
reconfortar	positive
reconocer	positive
reconocida#solvencia	positive
reconocimiento	positive
recortar	negative
recorte	negative
recortes	negative
recrear	positive
recriminar	negative
rectificar	negative
rectitud	positive
recuerdos	positive
recular	negative
recuperar	positive
recuperarse	positive
recusar	negative
redencion	positive
rediós	negative
reducción	negative
reducir#la#velocidad	negative
reducir	negative
redundante	negative
reemplazar	negative
referente	positive
refinado	positive
refinamiento	positive
refinar	positive
refocilar	positive
reforma	negative
reforzado	positive
reforzar	positive
refrescantemente	positive
refrescante	positive
refugiarse	positive
refugio	positive
refugio#seguro	positive
refunfuñar	negative
refunfuñón	negative
refutar	negative
regalar	positive
regalo	positive
regañadientes	negative
reganar	negative
regañar	negative
reganina	negative
regano	negative
regaño	negative
regiamente	positive
regio	negative
regocijadamente	positive
regocijar	positive
regocijarse	positive
regocijo	positive
regodear	positive
regodeo	positive
regresión	negative
regreso	positive
regurgitar	negative
rehén	negative
reherir	negative
rehilete	negative
rehusar	negative
reidor	positive
reincidencia	negative
reincidir	negative
reír	positive
relajación	positive
relajadamente	positive
relajado	positive
relajante	positive
relajar	positive
relajarse	positive
relamer	positive
relevante	positive
relucientemente	positive
reluciente	positive
relucir	positive
remanso#de#paz	positive
remordimiento	negative
removible	positive
renacimiento	positive
renacuajo	negative
rencilloso	negative
rencor	negative
rencorosamente	negative
rencoroso	negative
rendición	negative
rendimiento	positive
rendir#culto#a	positive
rendir	negative
rendirse	negative
reñir	negative
renombrado	positive
renombre	positive
renovacion	positive
renovado	positive
rentable	positive
renuncia	negative
renunciar#a	negative
renunciar	negative
reparación	positive
reparar	positive
reparo	negative
repartir	positive
repeler	negative
repelo	negative
repentino	negative
repercusión	positive
repetitivo	negative
reponerse	positive
reposo	negative
reprender	negative
reprensión	negative
represalia	negative
represión	negative
represivo	negative
reprimenda	negative
reprimir	negative
reprobación	negative
reprochable	negative
reproche	negative
reproducir	positive
repudiable	negative
repudiar	negative
repudio	negative
repugnadamente	negative
repugnancia	negative
repugnantemente	negative
repugnante	negative
repugnar	negative
repulsa	negative
repulsar	negative
repulsio	negative
repulsión	negative
repulsivamente	negative
repulsivo	negative
reputación	positive
reputado	positive
rertorcido	negative
rescisión	negative
reseco	negative
resentido	negative
resentimiento	negative
resentir	negative
resfriado	negative
resignación	negative
resistencia	negative
resistente	positive
resistir	positive
resolver	positive
resonar	positive
respaldar#a	positive
respaldar	positive
respaldo	positive
respetable	positive
respetado	positive
respetar	positive
respeto	positive
respetuoso	positive
respingar	negative
respiro	positive
resplandecer	positive
resplandor	positive
resquemor	negative
restar	negative
restaurar	positive
restringir	negative
resuelto	positive
resultón	positive
resumido	positive
retar	negative
reticencia	negative
reticentemente	negative
retirar	negative
reto	positive
retorcer	negative
retorcerse	negative
retorcido	negative
retractarse	negative
retrasado	negative
retrasar	negative
retrasarse	negative
retraso	negative
retroceder	negative
retroceso	negative
reunir#las#condiciones#necesarias	positive
revancha	negative
revelación	positive
reventar	negative
reventarse	negative
reverencia	positive
reverenciar	positive
revolcarse	negative
revoltoso	negative
revuelo	negative
reyerta	negative
rezagarse	negative
rico	positive
ridiculamente	negative
ridiculas	negative
ridiculizar	negative
ridículo	negative
ridiculos	negative
riesgo	negative
rigido	negative
riguroso	negative
rimbombante	negative
rina	negative
riña	negative
riqueza	positive
riquisima	positive
riquisimas	positive
riquísimo	positive
riquisimos	positive
risa	positive
risueno	positive
risueño	positive
rivalidad	negative
robar	negative
robo	negative
robustez	positive
robusto	positive
rocambolesco	negative
rocin	negative
rodeor	negative
rogar	negative
rollazo	negative
rollo	negative
romántico	positive
rompecabezas	negative
rompedor	positive
romper	negative
romperse	negative
roña	negative
roñosa	negative
roñoso	negative
roto	negative
rotundamente	positive
rotundo	positive
rotura	negative
rubia#de#bote	negative
rudamente	positive
rudo	negative
rufian	negative
rufián	negative
ruido	negative
ruidosamente	negative
Ruidos	negative
ruidoso	negative
ruina	negative
ruinas	negative
ruin	negative
ruinoso	negative
ruptura	negative
saber#a#rayos	negative
saber#de#buena#tinta	positive
saber#latín	positive
saber#más#que#los#peces#de#colores	positive
saber#más#que#los#ratones#colorados	positive
saber	positive
sabiamente	positive
sabiduría	positive
sabio	positive
saborear	positive
sabor	positive
sabotaje	negative
sabotear	negative
sabroso	positive
sacar#adelante	positive
sacar#de#quicio	negative
sacar#de#sus#casillas	negative
sacar#fuerzas#de#flaqueza	positive
sacar#las#castañas#del#fuego	positive
sacar#los#colores	negative
sacar#los#trapos#sucios	negative
sacar#pecho	positive
sacar#tajada	positive
saciar	positive
saciedad	positive
sacrificar	negative
sacrílego	negative
sacudida	negative
sagacidad	positive
sagazmente	positive
sagaz	positive
sagrado	positive
salado	positive
salamanca#para#comérsela	positive
salir#adelante	positive
salir#bien	positive
salir#corriendo	negative
salir#de#madre	negative
salir#de#marcha	positive
salir#de#marchuqui	positive
salir#por#la#tangente	negative
salirse#de#sus#casillas	negative
saltaron#todas#las#alarmas	negative
saludable	positive
saludar	positive
saludo	positive
saludos	positive
salud	positive
salvacion	positive
salvación	positive
salvador	positive
salvaguarda	positive
salvaguardar	positive
salvajemente	negative
salvaje	negative
salvar	positive
salvia	positive
sambenito	negative
saña	negative
sanción	negative
sandez	negative
sandunga	positive
sangrante	negative
sangrar	negative
sangre	negative
sangría	negative
sangriento	negative
sanguijuela	negative
sanguinario	negative
sano	positive
sañoso	negative
sanseacabó	negative
santificar	positive
santo	positive
santuario	positive
santurrón	negative
saquear	negative
saqueo	negative
sarao	negative
sarasa	negative
sarcasmo	negative
sarcástico	negative
sarpullido	negative
satánico	negative
satan	negative
satisfacción	positive
satisfacer	positive
satisfacible	positive
satisfactoriamente	positive
satisfactorio	positive
satisfecho	positive
saturación	negative
saturado	negative
saturar	negative
saturnino	negative
secreción	negative
secta	negative
secuela	negative
secuestrado	negative
secuestrar	negative
secuestro	negative
sed	negative
sedoso	positive
seducción	positive
seducir	positive
seductivo	positive
seductoramente	positive
segar#la#vida	negative
seguir#en#sus#trece	negative
seguramente	positive
seguridad	positive
seguro	positive
selecto	positive
sembrar#la#duda	negative
sencillez	positive
sencillísimo	positive
sencillo	positive
senil	negative
señorial	positive
sensacionalista	negative
sensacionalmente	positive
sensacional	positive
sensatamente	positive
sensatez	positive
sensato	positive
sensibilidad	positive
sensiblemente	positive
sensible	negative
sensiblero	negative
sensibloide	negative
sensualísimo	positive
sensual	positive
sentar#bien	positive
sentar#mal	negative
sentido#común	positive
sentimentalmente	positive
sentir	negative
separar	negative
separarse	negative
sequía	negative
ser#aficionado	positive
ser#carne#de#cañón	negative
ser#como#dos#gotas#de#agua	positive
ser#del#año#de#la#pera	negative
ser#del#año#de#la#polca	negative
ser#del#año#de#maricastaña	negative
ser#de#mírame#y#no#me#toques	negative
ser#efusivo	positive
serenar	positive
serenarse	positive
serenidad	positive
sereno	positive
seriamente	negative
seriedad	positive
ser#injusto	negative
serio	negative
ser#la#casa#de##tócame#roque	negative
ser#la#gota#que#colma#el#vaso	negative
ser#la#mar#de#salado	positive
ser#la#repanocha	positive
ser#la#última#coca#cola#del#desierto	positive
ser#más#cansón#que#novia#fea	negative
ser#más#corto#que#el#rabo#de#un#virus	negative
ser#más#falso#que#una#moneda#de#cuero	negative
ser#más#feo#que#pegar#a#un#padre	negative
ser#más#feo#que#picio	negative
ser#más#feo#que#un#kilo#de#mierda	negative
ser#más#lento#que#el#caballo#del#malo	negative
ser#más#listo#que#einstein	positive
ser#más#listo#que#el#hambre	positive
ser#más#malo#que#la#quina	negative
ser#más#papista#que#el#papa	negative
ser#más#pesado#que#una#vaca#en#brazos	negative
ser#más#puta#que#las#gallinas	negative
ser#más#salado#que#la#mar	positive
ser#más#tonto#que#abundio	negative
ser#más#tonto#que#mear#y#no#echar#gota	negative
ser#más#vago#que#la#chaqueta#de#un#guardia	negative
ser#más#viejo#que#la#moda#de#caminar#a#pie	negative
sermonear	negative
sermón	negative
ser#muy#leído	positive
ser#nadadora	negative
ser#pan#comido	positive
ser#pan#para#hoy#y#hambre#para#mañana	negative
ser#para#que#le#den#a#uno#de#comer#aparte	negative
serpentear	negative
ser#peor#el#remedio#que#la#enfermedad	negative
ser#pocos#y#parió#la#abuela	negative
ser#pocos#y#parió#la#burra	negative
ser#tonto#del#haba	negative
ser#un#águila	positive
ser#una#lumbrera	positive
ser#una#mosquita#muerta	negative
ser#una#tumba	positive
ser#un#borde	negative
ser#un#buitre	negative
ser#un#cero#a#la#izquierda	negative
ser#un#chorra	negative
ser#un#colgado	negative
ser#un#figura	positive
ser#un#gallina	negative
ser#un#hacha	positive
ser#un#lince	positive
ser#un#lobo#con#piel#de#cordero	negative
ser#un#manojo#de#nervios	negative
ser#un#manta	negative
ser#un#pelma	negative
ser#un#pulpo	negative
ser#un#venancio	negative
ser#un#venao	negative
ser#un#viva#la#virgen	negative
servicio#atento	positive
servicio#exquisito	positive
servidumbre	negative
servil	negative
sesgo	negative
severamente	negative
severidad	negative
severo	negative
sevicia	negative
sexi	positive
sexy	positive
shock	negative
sibarita	positive
sida	negative
si#hay#manera#humana	negative
siiii	positive
si#la#envidia#fuera#tiña#cuántos#tiñosos#habría	negative
silencioso	positive
simpatía	positive
simpaticamente	positive
simpatico	positive
simpático	positive
simpaticos	positive
simpatizar	positive
simpleza	negative
simplicidad	positive
simplista	negative
simplón	negative
sin#blanca	negative
sinceramente	positive
sinceridad	positive
sincero	positive
sin#contratiempos	positive
sin#defecto	positive
sin#duda	positive
sin#escrupulos	negative
sin#esfuerzo	positive
sin#éxito	negative
sinfónico	positive
sin#fundamento	negative
singular	positive
siniestramente	negative
siniestro	negative
sin#motivo	negative
sin	negative
si#no#quieres#caldo#toma#tres#tazas	negative
sin#pena#ni#gloria	negative
sin#razón	negative
sinrazón	negative
sin#sentido	negative
sin#tacha	positive
sin#valor	negative
sinvergüenza	negative
sinverguenzas	negative
sinvivir	negative
sí	positive
sistemáticamente	positive
sitiar	negative
situación#límite	negative
sniff	negative
snif	negative
soberbiamente	positive
soberbia	negative
soberbio	negative
sobrado	positive
sobreactuado	negative
sobrecogedor	negative
sobrecoger	negative
sobrecogido	positive
sobrecogimiento	positive
sobredosis	negative
sobrepasar	positive
sobrepujar	positive
sobresalientemente	positive
sobresaliente	positive
sobresalir	positive
sobresaltar	negative
sobriedad	positive
socarron	negative
socavar	negative
sociable	positive
socorro	negative
¡socorro!	positive
soez	negative
sofisticado	positive
sofocantemente	negative
sofocante	negative
sofocar	negative
sofocarse	negative
sojuzgar	negative
solazar	positive
solaz	positive
soleado	positive
soledad	negative
solemne	positive
solícito	positive
solidamente	positive
solidaridad	positive
solidario	positive
solidez	positive
sólido	positive
solitariamente	negative
solitario	negative
sollozar	negative
sollozo	negative
solo	negative
sólo	negative
solterito#y#cuarentón#qué#suerte#tienes#ladrón	positive
soltura	positive
solucionar	positive
solución	positive
solvencia	positive
solventar	positive
sombra	negative
sombrio	negative
sombrío	negative
someter	negative
soñado	positive
soñar#despierto	positive
soñar	positive
sonreír	positive
sonriente	positive
sonrisa	positive
soplón	negative
soportar	negative
sórdido	negative
sordo	negative
sorna	negative
sorprendente	positive
sorprender	negative
sorry	negative
sortilegio	positive
sosaina	negative
sosegado	positive
sosegar	positive
sosegarse	positive
sosiego	positive
soso	negative
sospecha	negative
sospechar	negative
sospechosamente	negative
sospechoso	negative
suavemente	positive
suave	positive
suavidad	positive
suavizar	positive
suavizarse	positive
subalterno	negative
subdesarrollado	negative
subestimar	negative
subir#a#la#chepa	negative
subir	positive
subirse#por#las#paredes	negative
sublevación	negative
sublime	positive
submundo	negative
subnormal	negative
subrealistas	negative
subsanar	positive
subscribirse	positive
subversivo	negative
subvertir	negative
subyugar	positive
suciedad	negative
Suciedad	negative
sucio	negative
sucisimo	negative
sucumbir	negative
sudaca	negative
sudoroso	negative
sueño	positive
sueño#reparador	positive
sueños	positive
suerte	positive
Suerte	positive
suficiencia	negative
sufridor	negative
sufrimiento	negative
sufrir#angustiosamente	negative
sufrir	negative
sugerencia	positive
sugerir	positive
suicida	negative
suicidar	negative
suicidio	negative
sulfurado	negative
sumamente	positive
sumir	negative
sumisamente	negative
sumiso	negative
sumo	positive
suntuosamente	positive
suntuoso	positive
superabundancia	positive
superabundante	positive
superar	positive
súpercéntrico	positive
superchería	negative
supercontento	positive
superficialidad	negative
superficialmente	negative
superficial	negative
superfluo	negative
superhéroe	positive
superheroico	positive
superiores	positive
superior	positive
superlativo	positive
supermadura	positive
supersencilla	positive
superstición	negative
superventas	positive
súplica	negative
suplicar	negative
suplicio	negative
supremo	positive
supresión	negative
suprimir	negative
surrealista	negative
surtido	negative
susceptible	negative
suscribir	positive
suscribirse	positive
suspender	negative
suspensión	negative
suspenso	negative
sustancialmente	positive
sustituir	negative
susto	negative
susurrado	negative
sutil	positive
tabú	negative
tacaño	negative
tacha	negative
tachar	negative
taciturnidad	negative
taciturno	negative
tacto	positive
taimado	negative
tajantemente	negative
talentazo	positive
talento	positive
talentoso	positive
talla	positive
tambalearse	negative
tañido	negative
taquillero	positive
tarado	negative
tarambana	negative
tarasca	negative
tardío	negative
tartamudear	negative
tartamudeo	negative
tarugo	negative
tedio	negative
te#doy#un#palo#que#te#avío	negative
temazo	positive
temblar	negative
temblón	negative
temblor	negative
tembloroso	negative
temerario	negative
temeridad	negative
temer	negative
temerosamente	negative
temeroso	negative
temible	negative
temor	negative
temorosamente	negative
tempestad	negative
tempestuoso	negative
tenacidad	positive
tenaz	positive
tenebrosamente	negative
tenebrosidad	negative
tenebroso	negative
tener#agallas	positive
tener#altura#moral	positive
tener#antipatía#a	negative
tener#buena#prensa	positive
tener#buen#ojo	positive
tener#chorra	positive
tener#como#protagonista#a	positive
tener#delito	negative
tener#dos#dedos#de#frente	positive
tener#el#guapo#subido	negative
tener#en#cuenta	positive
tener#éxito	positive
tener#frito	negative
tener#la#cabeza#a#pájaros	negative
tener#la#cabeza#hueca	negative
tener#la#cabeza#llena#de#pájaros	negative
tener#la#cabeza#llena#de#serrín	negative
tener#la#cara#muy#dura	negative
tener#la#lágrima#fácil	negative
tener#lo#que#hay#que#tener	positive
tener#los#nervios#a#flor#de#piel	negative
tener#los#pies#en#el#suelo	positive
tener#los#pies#en#la#tierra	positive
tener#mala#baba	negative
tener#mala#leche	negative
tener#mano#izquierda	positive
tener#más#años#que#carracuca	negative
tener#más#años#que#matusalén	negative
tener#más#cara#que#espalda	negative
tener#más#cuento#que#calleja	negative
tener#más#morro#que#cascorro	negative
tener#más#paciencia#que#el#santo#job	positive
tener#más#peligro#que#un#mono#con#una#caja#de#bombas	negative
tener#más#recursos#que#mc#guiber	positive
tener#miedo	negative
tener#mucha#cara	negative
tener#mucha#jeta	negative
tener#mucha#miga	negative
tener#mucho#corazón	positive
tener#muchos#humos	negative
tener#muy#creído	negative
tener#muy#pocas#luces	negative
tener#pavor#a	negative
tener#potra	positive
tener#razón	positive
tener#rostro#de#cemento	negative
tener#tablas	positive
tener#tiesas	negative
tener#todo#clarísimo	positive
tener#una#avería	negative
tener#una#rosa#en#el#culo	positive
tener#un#nudo#en#la#garganta	negative
tener#un#pie#en#la#tumba	negative
tener#un#rifirrafe	negative
tengo#monos#en#la#cara	negative
tensar	negative
tensión	negative
tenso	negative
tentación	negative
tentadoramente	positive
tentador	positive
tente#y#no#te#menees	negative
tercamente	negative
tercermundista	negative
terco	negative
tergiversación	negative
tergiversar	negative
terminal	negative
terneza	positive
ternura	positive
terquedad	negative
terremoto	negative
terriblemente	negative
terrible	negative
terroríficamente	negative
terrorífico	negative
terrorismo	negative
terrorista	negative
terror	negative
tesón	positive
tesoro	positive
testarudez	negative
testarudo	negative
tetrico	negative
Tetrico	negative
tétrico	negative
te#viene#que#ni#pintado	positive
tiburón	negative
tiernamente	positive
tierno	positive
tijeretazo	negative
timador	negative
timar	negative
timidamente	negative
tímidamente	negative
timidez	negative
tímido	negative
timo	negative
Timo	negative
timorato	negative
tinieblas	negative
tirado	positive
tirania	negative
tiranía	negative
tiránico	negative
tirano	negative
tirar#de#la#lengua	negative
tirar#de#los#pelos	negative
tirar#el#rollo	negative
tirar#la#casa#por#la#ventana	negative
tirar#la#toalla	negative
tirar	negative
tirar#un#farol	negative
tiritar	negative
tiro#errado	negative
tiroteo	negative
tirria	negative
titán	positive
títere	negative
tocado	negative
tocar#la#china	negative
tocar#los#cojones	negative
tocar#los#huevos	negative
tocho	negative
todopoderoso	positive
todo	positive
tod@s	positive
tods	positive
toldo	negative
tolerante	positive
tolerar	positive
tomadura#de#pelo	negative
tomadura	negative
tomar#el#pelo	negative
tomar#represalias#contra	negative
tomate	negative
tongo	negative
tontamente	negative
tonterías#las#justas	negative
tonterías	negative
tonto	negative
torcedura	negative
torcer	negative
torcerse	negative
torcido	negative
torear	negative
tormenta	negative
tormento	negative
tormentoso	negative
torpemente	negative
torpe	negative
torpeza	negative
torrente	negative
tórrido	positive
tortazo	negative
tortuosamente	negative
tortuoso	negative
tortura	negative
torturar	negative
toscamente	negative
tosco	negative
tostón	negative
totalidad	positive
totalitario	negative
toxicómano	negative
toxico	negative
tóxico	negative
toxina	negative
tozudamente	negative
trabajado	positive
trabajo#duro	negative
traer#cola	negative
tráfico	negative
tragar#dobladas	negative
tragar#una#mentira	negative
tragedia	negative
trágicamente	negative
trágico	negative
traicionado	negative
traicionar	negative
traicioneramente	negative
traicionero	negative
traición	negative
traidor	negative
trama	negative
tramar	negative
trampa	negative
tramposo	negative
tranquilamente	positive
tranquilidad	positive
tranquilizar	positive
tranquilo	positive
Tranquilo	positive
transgresor	negative
transparencia	positive
transparente	positive
transportar	positive
transporte	positive
trapisonda	negative
trascendental	positive
trascendente	positive
trastada	negative
traste	negative
trasto#inútil	negative
trastornado	negative
trastornar	negative
trastorno	negative
tratable	positive
tratar#a#una#como#a#una#reina	positive
tratar#como#a#un#trapo	negative
tratar#con#condescendencia	negative
trato#familiar	positive
trato	positive
trauma	negative
traúmatico	negative
traumático	negative
traumatizado	negative
traumatizar	negative
travesura	negative
travieso	negative
trazar	negative
tremebundo	negative
tremendamente	negative
tremendista	positive
tremendo	negative
trillado	negative
trincar	negative
tripas	negative
tristemente	negative
triste	negative
Triste	negative
tristeza	negative
tristón	negative
triunfador	positive
triunfalmente	positive
triunfal	positive
triunfantemente	positive
triunfante	positive
triunfar	positive
triunfo	positive
triza	negative
trizas	negative
trola	negative
tronchar#de#risa	positive
tropelía	negative
tropezar	negative
tropezón	negative
truculento	negative
truño	negative
tufo	negative
tugurio	negative
tuitivo	positive
tumba	negative
tumbarse#al#sol	positive
tumulto	negative
tumultuosamente	negative
tumultuoso	negative
túnido	negative
turbación	negative
turbado	negative
turbar	negative
turbio	negative
turbulento	negative
tururú	negative
ubérrimo	positive
ubicación#fantástica	positive
ubicación#ideal	positive
ufanamente	positive
ufania	negative
ufanía	positive
ufano	positive
úlcera	negative
ultimar	positive
ultimatum	negative
ultimátum	negative
ultrajante	negative
ultrajar	negative
ultraje	negative
ultratumba	negative
unánime	positive
una#vez#maté#un#perro#y#me#llaman#mataperros	negative
una#y#no#más	negative
un#baño#al#año#no#hace#daño	negative
unción	positive
un#día#de#perros	negative
único	positive
unión	positive
unirse	positive
universal	positive
urgencia	negative
urgentemente	negative
urgente	negative
usgo	negative
usurero	negative
usurpador	negative
usurpar	negative
utilidad	positive
utilísimo	positive
utilización	positive
útil	positive
Vacaciones	positive
vaciar	negative
vaciarse	negative
vacilar	negative
vacio	negative
vacío	negative
vacuo	negative
vagabundo	negative
vago	negative
vaguear	negative
valedero	positive
valentía	positive
¡vale!	positive
vale	positive
valerosamente	positive
valeroso	positive
valía	positive
validación	positive
validez	positive
válido	positive
valientemente	positive
valiente	positive
valimiento	positive
valioso	positive
valoración	positive
valorar	positive
valorarse	positive
valorizarse	positive
valor	positive
vampiro	negative
vandalismo	negative
vándalo	negative
vanguardista	positive
vanidad	negative
vanidosamente	negative
vanidoso	negative
vano	negative
vareta	negative
vaya	negative
vaya#por#dios	negative
vedar	negative
vehemencia	negative
vehemente	positive
vejación	negative
vejar	negative
veloz	positive
vencedor	positive
vencer#a	positive
vencer	positive
vencido	negative
veneno	negative
venenosamente	negative
venenoso	negative
venerable	positive
veneración	positive
venerar	positive
venganza	negative
vengar	negative
vengativamente	negative
vengativo	negative
venir#abajo	positive
venir#a#joder#la#marrana	negative
venir#al#mundo#con#un#pan#bajo#el#brazo	positive
venir#bien#a	positive
ventaja	positive
ventajosamente	positive
ventajoso	positive
ventolera	negative
venturosamente	positive
venturoso	positive
veracidad	positive
veraniego	positive
veraz	positive
ver#con#buenos#ojos	positive
verdaderamente	positive
verdadero	positive
verdad	positive
verde	negative
verdugo	negative
verecundia	negative
verecundio	negative
verecundo	negative
vergonzosamente	negative
vergonzoso	negative
verguenza	negative
vergüenza	negative
verídico	positive
ver#la#luz	positive
ver#la#paja#en#el#ojo#ajeno	negative
ver#las#estrellas	negative
ver#las#orejas#al#lobo	negative
ver#los#toros#desde#la#barrera	negative
ver#menos#que#pepe#leches	negative
ver#negras	negative
ver#oír#y#callar	negative
versatilidad	positive
versátil	positive
vertedero	negative
ver#venir	negative
vesania	negative
vesánico	negative
vetar	negative
veto	negative
viabilidad	positive
viable	positive
víbora	negative
vibrantemente	positive
vibrante	positive
viciado	negative
vicio	negative
víctima	negative
victimar	negative
victorear	positive
victoria	positive
victorioso	positive
viejisima	negative
vigorizante	positive
vigorizar	positive
vigorosamente	positive
vigoroso	positive
vigor	positive
vilipendiar	negative
vilipendio	negative
vilmente	negative
vil	negative
vinagre	negative
violación	negative
violador	negative
violar	negative
violencia	negative
violentamente	negative
violento	negative
viperino	negative
virguería	positive
vírico	negative
virtud	positive
virtuosamente	positive
virtuoso	positive
virulencia	negative
virulentamente	negative
virulento	negative
virus	negative
víscera	negative
viscoso	negative
visionario	positive
visita#obligada	positive
vistas#increíbles	positive
visto#bueno	positive
vistoso	positive
vitalidad	positive
vital	positive
vitando	negative
vitorear	positive
vítor	positive
vitriolico	negative
vituperio	negative
viva	positive
vivaz	positive
viveza	positive
vívidamente	positive
vívido	positive
vivificar	positive
vivir#del#aire	negative
vivir	positive
vivo	positive
voceador	negative
vociferador	negative
vociferante	negative
vociferar	negative
voladura	negative
volar	negative
volátil	negative
volcar	negative
voluntariamente	positive
voluntarioso	positive
voluptuoso	positive
volver#la#espalda	negative
volver#loco	negative
volver#por#sus#fueros	positive
vomitar	negative
vomitivo	negative
vomito	negative
vómito	negative
voraz	negative
vulgaridad	negative
vulgar	negative
wapa	positive
wifi#gratuito	positive
xenofobia	negative
yeah	positive
yermo	negative
yupi	positive
zafio	negative
zaherir	negative
zahiriente	negative
zamarro	negative
zamparse	negative
zángano	negative
zangarriana	negative
zarrías	negative
zopenco	negative
zoquete	negative
zorra	negative
zozobrar	negative
zumbado	negative
zumbido	negative
zurcido	negative
zurcir	negative
zurrar	negative
zurullo	negative

#EMOTICONS
SMILEYEMOT      positive
CRYEMOT negative
SHOCKEMOT       negative
MUTEEMOT        negative
ANGRYEMOT       negative
KISSEMOT        positive
SADEMOT negative

#INTERJECTIONS
INTERPOS        positive
INTERNEG        negative
